CREATE SCHEMA eleicao_2024;
SET search_path TO eleicao_2024;

2) 

SELECT nm_urna_candidato,nm_candidato
FROM candidato
WHERE nm_ue = 'UBERLÂNDIA'
ORDER BY nm_candidato DESC

RESULTADO : 

"ZEIZA DOJO"	"ZEIZA MATILDES DA SILVA"
"LUIZ MONTANA"	"ZEFERINO LUIZ SANTOS"
"NENENZINHO"	"WILSON MARTINS SANTANA"
"WILMA DA SILVA"	"WILMA DA SILVA"
"WILLIAM MINEIRO"	"WILLIAM DOMINGOS"
"WESLEY JUBAL"	"WESLEY SOARES DOS SANTOS"
"WEMERSON NEGRÃO"	"WEMERSON HONORATO DE SOUZA"
"WELITON ARMONDS"	"WELITON FELICIANO ARMANDES"
"BEKA TREZE"	"WEBERSON DOS REIS GOMES"
"WARLEY"	"WARLEY EUSTAQUIO RODRIGUES ALVES"
"PASTOR WANDERSON"	"WANDERSON TELLES DOS SANTOS"
"ANDERSON DO CIRCO"	"WANDERSON BATISTA FERREIRA"
"WANDERLAN PIMENTA"	"WANDERLAN PIMENTA DE SOUZA"
"WALQUIR"	"WALQUIR CLEUTON DO AMARAL"
"WALLACE ALECRIM"	"WALLACE FERNANDES DE ALECRIM"
"WAGNA CORREIA"	"WAGNA APARECIDA CORREIA TIAGO"
"VIVIANE SABINO"	"VIVIANE APARECIDA DA SILVA"
"VITOR MANUTENÇÕES"	"VITORNELIO EZEQUIEL DE SOUZA"
"VERÔNICA FRAGA"	"VERÔNICA CAROLINA MATEUS FRAGA"
"VERA PRIMAVERA"	"VERA PRIMAVERA RODRIGUES"
"VÂNIA MADALENA"	"VÂNIA MADALENA MENDONÇA"
"VANESSA SANTOS"	"VANESSA GONCALVES SANTOS"
"NENZINHO"	"VANDERSON ESTEVÃO SOBRINHO"
"PELIZER"	"VANDERLEI PELIZER PEREIRA"
"VALTIM DO CARVAO"	"VALTER VELASCO DE ANDRADE JUNIOR"
"VALTER CABELO"	"VALTER LUIZ TAVARES"
"VALÉRIA MORAIS ADVOGADA"	"VALÉRIA SILVA MORAIS RODRIGUES"
"VALÉRIA PIANGELI"	"VALÉRIA PIANGELI TAVARES"
"PASTOR VALDEIR JOSÉ"	"VALDEIR JOSÉ PEREIRA"
"CEMIR PIETRO"	"VALCEMIR NAZARE SILVA"
"DJ BAD BOY"	"UINTER ARAUJO SILVA"
"UERLEI VAZANTE"	"UERLEI JOSE DE SOUZA"
"TIAGO SANTORI"	"TIAGO FERREIRA SANTOS"
"THIAGO FERNANDES"	"THIAGO FERNANDES MENDES DA SILVA"
"THIAGO PADRINHO DO IPANEMA"	"THIAGO DE OLIVEIRA SANTOS"
"THEREZINHA MENEZES"	"THEREZINHA DE JESUS MENEZES SABIO"
"THAÍS CAMARGOS"	"THAÍS SOUSA CAMARGOS"
"THAÍS ANDRADE"	"THAÍS ANDRADE SILVA"
"TEOBALDO TERÊNCIO"	"TEOBALDO TERÊNCIO"
"TATY MARTINS"	"TATIANE BATISTA MARTINS CORREIA"
"TÂNIA DA SAÚDE"	"TÂNIA LÙCIA DOS SANTOS"
"JUNINHO GÁS"	"SYLVIO DE OLIVEIRA JUNIOR"
"SUSI FEOLI"	"SUSILENE FERREIRA DE OLIVEIRA"
"STEVERSON DESPACHANTE"	"STEVERSON MARQUES DOS SANTOS"
"STEFANE LAIRA"	"STEFANE LAIRA MIRANDA PEREIRA"
"SÔNIA DO SHOPPING PARK"	"SÔNIA SOARES DE ARAÚJO BESSA"
"SOL DO TURISMO"	"SOLEMAR BORGES"
"LORRAN DUBEM"	"SOCRATES RODRIGUES QUEIROZ"
"SIMONIDES RODRIGUES"	"SIMONIDES RODRIGUES DE LIMA"
"SIMONE LORA PROTETORA"	"SIMONE BATISTA PEREIRA"
"SILVIO SINDICO"	"SILVIO JOSÉ DOS SANTOS"
"SILVIO SANTANA"	"SILVIO FERREIRA DE SANTANA"
"SILVIO BARCELOS"	"SILVIO BRAZ DE BARCELOS"
"SÍLVIO PIZZARELLA"	"SÍLVIO ALVES CAMILO"
"SILVÂNIA FALA SIL"	"SILVÂNIA LOPES DE SOUZA CAMPOS"
"DIRETORA SILESIA"	"SILESIA VERSIANI MAGALHAES"
"SEVERTON"	"SEVERTON PEREIRA DA SILVA"
"SÉRVIO TÚLIO"	"SERVIO TULIO FELIX SIMÕES FILHO"
"SERGIO SOUSA"	"SÉRGIO RODRIGUES DE SOUSA"
"SÉRGIO BELO BICHEIRO"	"SÉRGIO MAURO BELO"
"TENENTE LUCIO"	"SERGIO LUCIO DE ALMEIDA"
"SERJÃO CARVALHO"	"SERGIO GUSTAVO CARVALHO"
"SERGIO DO BOM PREÇO"	"SERGIMAR ANTÔNIO DE MELO"
"SELMA PRADO"	"SELMA IÊDA VASCONCELOS PRADO"
"SEBASTIÃO PEDRO"	"SEBASTIÃO PEDRO DE BARROS"
"TIÃOZINHO JARDIM BRASÍLIA"	"SEBASTIÃO CAETANO DOMINGOS"
"SARA PRADO"	"SARA PRADO DE OLIVEIRA"
"SANDRA LUIZA"	"SANDRA LUIZA ALVES GODOY MALASPINA"
"SANDRA PODEROSA"	"SANDRA APARECIDA JOSIAS"
"SAMUEL SAMUCA"	"SAMUEL PEREIRA MOREIRA"
"SAMOEL"	"SAMOEL MOURA DA SILVA"
"RUTH DO MORUMBI"	"RUTH GONCALVES BORGES"
"RUTE SANTOS"	"RUTE CANDIDA DA SILVA SANTOS"
"ROSA BRANDÃO"	"ROSILENE DE OLIVEIRA BRANDÃO SILVA"
"ROSY QUEIROZ"	"ROSICLEIA QUEIROZ DOS SANTOS"
"ZEZINHO MENDONÇA"	"ROSENVALDO CORREIA DE MENDONÇA"
"ROSENEY DO CENÁCULO"	"ROSENEY JOSE DOS ANJOS"
"ROSY JARDIM CELIA"	"ROSELIA ALVES DOS SANTOS"
"ROSELI DO ACLIMAÇÃO"	"ROSELI MARTINS DE OLIVEIRA"
"DRA CALVÍCIE ROSE CAMPOS"	"ROSE MARY MARTINS FERNANDES"
"ROSE MARA"	"ROSE MARA ESPÍNDOLA ANTUNES"
"ROSÂNGELA"	"ROSANGELA CRISTINA DE MOURA"
"ROSANA GUERREIRA"	"ROSANA ABADIA FERREIRA"
"ROQUE DE MORAES"	"ROQUE ANTONIO DE MORAES"
"DR. ROOSEVELT"	"ROOSEVELT JOAO MARQUES"
"RONINHO"	"RONES BARBOSA"
"RONALDO DA SAÚDE"	"RONALDO ROSA DE SOUZA"
"RONALDO DO ESPETINHO"	"RONALDO NUNES DE SOUZA"
"RONALDO TANNUS"	"RONALDO CESAR VILELA TANNUS"
"INSPETOR RONALDO BASTOS"	"RONALDO BASTOS RAMOS FILHO"
"PROFESSOR RONALDO"	"RONALDO AMÉLIO FERREIRA"
"ROLDÃO MAIA"	"ROLDÃO MAIA DE OLIVEIRA"
"ZOOIN DO LARANJEIRAS"	"ROGERIO SARAIVA"
"ROGERIO DANTAS"	"ROGERIO BALBINO DANTAS"
"RODRIGO CARDOSO DA HABITAÇÃO"	"RODRIGO SILVA CARDOSO"
"RODRIGO DOIDO LANCHES"	"RODRIGO RAMOS DE MORAIS"
"RODRIGO NICOLAU"	"RODRIGO NICOLAU ELIAS DE OLIVEIRA"
"RODRIGO CNH "	"RODRIGO JOSÉ RIBEIRO"
"DR. ROBISON DIVINO"	"ROBISON DIVINO ALVES"
"ROBERTO DA PET HOUSE"	"ROBERTO SIDNEI DA SILVEIRA"
"ROBERTO CADEIRANTE"	"ROBERTO FERREIRA FONTOURA"
"ROBERTO BARANOWSKI"	"ROBERTO CARDOSO BARANOWSKI"
"ROBERTHA BALDOINO"	"ROBERTA BALDOINO FRANCO"
"SGT RILDO"	"RILDO DE OLIVEIRA SILVA"
"RICHARD"	"RICHARD XAVIER DA SILVA VIEIRA"
"RICARDÃO DO POSTO"	"RICARDO PEREIRA NETTO"
"RICARDO SANTOS"	"RICARDO DOS SANTOS"
"REYLER VALDIVIA"	"REYLER HERCULANO VALDIVIA"
"RENATO VIEIRA"	"RENATO DE SOUZA VIEIRA"
"RENATA ANDRADE"	"RENATA SILVA DE ANDRADE"
"REJANE SAM BAR"	"REJANE RODRIGUES DE SOUZA"
"REJANE SILVA"	"REJANE MARIA ALVES SILVA"
"REGINALDO RIBEIRO"	"REGINALDO SILVA RIBEIRO"
"REGINALDO DO TRANSPORTE"	"REGINALDO RODRIGUES DA SILVA"
"REGINALDO RESENDE"	"REGINALDO ALVES RESENDE"
"REGINA ARAÚJO"	"REGINA APARECIDA DE ARAÚJO"
"RAYR RRTV"	"RAYR GONÇALVES LIMA"
"RAQUEL CROSCATTO"	"RAQUEL SILVEIRA CROSCATTO"
"RAPHAEL LELES"	"RAPHAEL MESSIAS LELES"
"STANLEY"	"RANIERY STANLEY GONCALVES"
"RAFAEL DO MANSOUR"	"RAFAEL CAMARGO SILVA"
"PRISCILA DA ZOONOSES"	"PRISCILA ALVES BATISTA"
"PEDRO MIGUEL PEDRINHO"	"PEDRO MIGUEL DE ARAUJO"
"PEDRÃO"	"PEDRO GENOINO DA SILVA"
"PEDRO VAZ"	"PEDRO DOS REIS VAZ NETO"
"PAULO SÉRGIO"	"PAULO SÉRGIO FERREIRA"
"PAULO GOMES"	"PAULO ROBERTO SILVA GOMES"
"PAULO QUITES"	"PAULO MARCOS DE OLIVEIRA QUITES"
"PAULO NAVES"	"PAULO CESAR DE OLIVEIRA NAVES"
"SAPIM BATERA"	"PAULO CÉSAR CUSTÓDIO"
"PAULO CESAR PC"	"PAULO CESAR ALVES ROCHA"
"PATRIK BORGES"	"PATRIK BORGES DA SILVA"
"PATRÍCIA GOUVEIA"	"PATRÍCIA GOUVEIA DAMASCENO"
"PATRÍCIA LOPES"	"PATRÍCIA CRISTINA SILVA LOPES"
"PASTORA PATRICIA DO SOCIAL"	"PATRICIA ADRIANA DOS SANTOS SILVA"
"OVIDIO LOJA TUBALINA"	"OVIDIO ANTONIO DE CARVALHO"
"TONY BRETAS"	"OTEVALDO ANTÔNIO DA SILVA"
"PROFESSOR OSWALDO JUNIOR"	"OSWALDO DE SOUZA JUNIOR"
"OSWALDO ANDRADE"	"OSWALDO ANDRADE FILHO"
"OSVALDO ARAUJO"	"OSVALDO LEANDRO DE ARAUJO"
"OSMAR JARDINEIRO"	"OSMAR LUIZ DE FREITAS"
"CAPITÃO DUQUE"	"OSMAR DUQUE DA SILVA"
"ZANGÃO"	"OSMAR DONIZETE DA SILVA"
"DR OSAIR PÉ DE FERRO"	"OSAIR JOSE FERNANDES SANTIAGO"
"OLIVIA ROLAND"	"OLIVIA APARECIDA ROLAND"
"ODAIR JOSE"	"ODAIR JOSE DA SILVA"
"MALAQUIAS PRETO"	"OCIMAR CÂNDIDO FERREIRA MALAQUIAS PRETO"
"NIVALDO AFONSO"	"NIVALDO AFONSO"
"NILTINHO DO SHOPPING PARK"	"NILTON CARLOS ALVES DURÃES"
"TIM CAETANO"	"NILTON CAETANO DOS SANTOS"
"NILSON GOMES JB"	"NILSON EURIPEDES GOMES"
"YSYS MONTEIRO"	"NILIA RAMOS PEREIRA"
"NELSON MECÂNICO"	"NELSON JOSE DA COSTA"
"MAGOO"	"NEIVALDO HONÓRIO DA SILVA"
"NEI BORGES"	"NEI CARLOS BORGES"
"NEEMIAS MIQUEIAS"	"NEEMIAS MIQUEIAS SILVA SOARES"
"NATH DA BOUTIQUE DA NATH"	"NATHÁLIA SOUZA PIRES"
"MURILO"	"MURILO FERREIRA ALVES"
"MORGANNA DE CÁSSIA"	"MORGANNA DE CÁSSIA VIEIRA SOUSA"
"XUXA"	"MOISES CARLOS DA SILVA"
"MISAC LACERDA"	"MISAC LACERDA MENDONCA"
"MINEIA DO GLORIA"	"MINEIA NUNES DE SOUZA CARVALHO RENDE"
"MICHELLE MILLA"	"MICHELLE MILLA DE OLIVEIRA AMARAL"
"MICHAEL AMARAL"	"MICHAEL AMARAL FERREIRA"
"MEIRE ANDRADE"	"MEIRE MARIA DE ANDRADE"
"MAYK"	"MAYK ANTONIO ALVES MOREIRA"
"MAYCON GARCIA"	"MAYCON GARCIA DE FREITAS"
"MAX DO SUSHI"	"MAXWELL RODRIGUES COSTA"
"MAX BULLS"	"MAXIMINO MENDES RIBEIRO NETO"
"MATHEUS RAMOS"	"MATHEUS TOMAZ GONÇALVES RAMOS"
"MATHEUS MOTONEGO"	"MATHEUS FILLIPE GONCALVES PEREIRA"
"MATEUS SANTOS"	"MATEUS SILVA SANTOS"
"MATEUS ANTUNES"	"MATEUS ANTUNES GRACIANO"
"DOCA MASTROIANO"	"MASTROIANO DE MENDONÇA ALVES"
"PROF MARKUS FELIPE"	"MARKUS FELIPE DE OLIVEIRA SALLES"
"MARIO SOUZA"	"MARIO SOUZA ARAUJO"
"MÁRIO KNICHALLA CAÇADOR"	"MÁRIO KNICHALLA NETO"
"MARIO JUNIOR"	"MARIO JOSE DE SOUSA JUNIOR"
"MARILSON"	"MARILSON FERNANDES DE OLIVEIRA"
"TEREZINHA DO BISTRÔ"	"MARIA TEREZINHA LIMA DE SOUZA"
"MARITA PROTETORA"	"MARIA RITA DE ASSIS RABELO TEIXEIRA"
"CACICA KAWANY"	"MARIA DE LOURDES LIMA SOARES"
"FÁTIMA CATUNDA"	"MARIA DE FÁTIMA SOUSA CATUNDA"
"FÁTIMA DELFINO"	"MARIA DE FÁTIMA DELFINO"
"CONCEIÇÃO MELO"	"MARIA CONCEIÇÃO DE MELO"
"MARIA CLARA"	"MARIA CLARA SANTOS PASSOS"
"MARIA CAMILA"	"MARIA CAMILA DA SILVA"
"CIDA DO BUSÃO"	"MARIA APARECIDA FERNANDES"
"MARIA TANNUS"	"MARIA ABADIA PERES TANNUS"
"MARGARETH MEG"	"MARGARETH LOUISE LAMOUNIER"
"MARQUINHO RAPADURA"	"MARCOS RIBEIRO DE MORAIS"
"MARCOS ARANTES"	"MARCOS ANTONIO SILVA ARANTES"
"MARCO TÚLIO VEIGA"	"MARCO TULIO VEIGA"
"FLÁVIO DO TRANSPORTE"	"MARCO FLÁVIO RODARTE PARREIRA"
"MÁRCIO DÚLIO DO TRANSPORTE"	"MÁRCIO DÚLIO DE OLIVEIRA"
"MARCIO CORRETOR"	"MARCIO DE LOURDES SILVA"
"MÁRCIO DO MEIO AMBIENTE"	"MÁRCIO ANTÔNIO LOURENCO MARTINS"
"NEGÃO DO ONIBUS"	"MARCIANO CARDOSO DE SOUZA"
"MARCELO OLIVEIRA"	"MARCELO OLIVEIRA SILVA"
"DR. MARCELO CUNHA"	"MARCELO MENDES CUNHA"
"MANOEL DO MORANGO"	"MANOEL NOGUEIRA DA COSTA"
"MAGALHÃES RAMOS"	"MAGALHÃES RAMOS MACHADO"
"MACIEL AMORIM"	"MACIEL FERNANDES RODRIGUES AMORIM"
"DUDU LUIZ EDUARDO"	"LUIZ EDUARDO RIBEIRO DE SA"
"LUIZ CARLOS SARAIVA"	"LUIZ CARLOS SARAIVA"
"PASTOR TROVÃO"	"LUIZ ALEXANDRE NEVES DUARTE"
"LUISMAR"	"LUISMAR ALVES DE OLIVEIRA"
"LUIS PAULO"	"LUIS PAULO FERREIRA ROCHA"
"TAVIN"	"LUIS OTÁVIO ALVES GOMES"
"LUIS GUSTAVO ROEL"	"LUIS GUSTAVO ROEL DA SILVA"
"TIA LÚ DA CRECHE"	"LUCILEIDE MARIA DA SILVA"
"LUCIANA SANTOS"	"LUCIANA APARECIDA DA SILVA SANTOS"
"LUCÉLIA ROQUETE"	"LUCELIA ROQUETE FRANCO"
"LUKINHA DO PARQUE"	"LUCAS OLIVEIRA VILAS BOAS"
"LOURIVAL SANTOS"	"LOURIVAL APARECIDO SERAFIM PEIXOTO DOS SANTOS"
"LORRAINE MARTINS"	"LORRAINE MARTINS DA SILVA"
"LORENA OLIVEIRA"	"LORENA SANTOS OLIVEIRA"
"LORENA MONIQUE"	"LORENA MONIQUE FERREIRA DE ALMEIDA"
"LIZA PRADO"	"LIZA FERNANDES PRADO"
"DELEGADA LIA VALECHI"	"LIA EUNICE VALECHI DA SILVA"
"LEOPOLDO NAPOLEÃO"	"LEOPOLDO NAPOLEAO DE OLIVEIRA NETO"
"LEONIDIO BOUÇAS"	"LEONIDIO HENRIQUE CORREA BOUÇAS"
"REPORTER LEO SOARES"	"LEONARDO SOARES FERREIRA"
"LEONARDO BRANT"	"LEONARDO SANTOS FERREIRA"
"LEONARDO NATALI"	"LEONARDO NATALI CHRISTINO"
"LEONARDO ALMEIDA"	"LEONARDO ALMEIDA DE JESUS"
"LENINHA DO MORADA NOVA"	"LENI DA SILVA"
"LEIDE EVANGELISTA"	"LEIDIANE BATISTA EVANGELISTA"
"MARCIA BATATINHA"	"LEIDA MARCIA DE OLIVEIRA MAXIMO"
"SARGENTO PRADO"	"LEANDRO OLIVEIRA DO PRADO"
"LEANDRO MENDES"	"LEANDRO MENDES DE ARAUJO"
"LEANDRO NEVES"	"LEANDRO CASSIANO NEVES"
"LAYLA MELLO"	"LAYLA DANIELA DE MELO"
"LAURA MARIA"	"LAURA MARIA BARBOSA DA SILVA"
"LAISA DO JARDIM CELIA"	"LAISA PEREIRA DA ROCHA"
"LAADE OLIVEIRA"	"LAADE DE OLIVEIRA SILVA"
"KLEBER SANDES"	"KLEBER DE OLIVEIRA SANDES"
"DRA KETHULLYN BRASILEIRO"	"KETHULLYN REIS BRASILEIRO DE FREITAS"
"KENYA BORGES"	"KENYA APARECIDA BORGES"
"PROFESSORA KELLY ASSIS"	"KELLY CRISTINA PEREIRA DE ASSIS"
"KELI MELO"	"KELI DE MELO SILVA LANES"
"KAROL CORDEIRO"	"KAROLINA DE CASTRO CORDEIRO ALVARENGA"
"JUSCLEITON MARRECO"	"JUSCLEITON DE OLIVEIRA"
"JUNIA ALBA"	"JUNIA ALBA GONÇALVES"
"SARGENTO DINIZ"	"JUMAR JACOB DINIZ"
"JULIO DA APOSENTADORIA"	"JULIO CESAR ORIAS TEODORO"
"JÚLIO NEWS"	"JÚLIO CESAR FELISBINO"
"SCHNEIDER DA MANUTENÇÃO"	"JULIANO SCHNEIDER DAS NEVES"
"JULIANE PACHECO"	"JULIANE MARTINS PACHECO"
"JULIANA SHOPPING PARK"	"JULIANA MARIA DOS SANTOS"
"JUCÉLIO ARENA FIGHT"	"JUCÉLIO SILVA CORDEIRO"
"JUCELIA SOUZA"	"JUCELIA DE SOUZA"
"JOSIMAR JOSÉ"	"JOSIMAR JOSÉ FERNANDES DE JESUS"
"JOSIMAR JOSE"	"JOSIMAR JOSE FERNANDES DE JESUS"
"SORRISO JT DO FORRO"	"JOSEILDO TEOTONIO DA SILVA"
"ZÉ RONALDO"	"JOSE RONALDO PEREIRA"
"PROFESSOR ZÉ RICARDO"	"JOSE RICARDO DE SOUSA LIMA"
"J SANTOS"	"JOSÉ PEREIRA DOS SANTOS"
"JOSÉ NICOMEDES DO LARANJEIRAS"	"JOSÉ NICOMEDES FERNANDES MANZINI"
"JOSÉ MACIEL"	"JOSÉ MACIEL CAMPOS"
"ZÉ FOLHINHA"	"JOSE JERONIMO SOBRINHO"
"JOSÉ HUMBERTO LEMES"	"JOSÉ HUMBERTO LEMES"
"PASTOR JOSÉ FURTADO"	"JOSÉ FURTADO DE SOUSA"
"CABO EMÍDIO"	"JOSÉ EMÍDIO PEREIRA"
"ZEZINHO MEU PREZADO"	"JOSÉ APARECIDO RIBEIRO"
"JORGE SILVA"	"JORGE PEREIRA DA SILVA"
"DR JON"	"JONES MALANCHE"
"JONATHAN DA SAÚDE"	"JONATHAN HENRIQUE SANTOS"
"JUNIOR FREITAS"	"JONATAS MENDONÇA DE FREITAS JUNIOR"
"JOICE ELIAS"	"JOICE ELIAS DA SILVA"
"JOELISIO CORDEIRO"	"JOELISIO SILVA CORDEIRO"
"JOEL RODRIGUES"	"JOEL RODRIGUES DE PAULA"
"JOEL SANTOS"	"JOEL JESUS DOS SANTOS"
"JOÃO VITOR MACEDO"	"JOÃO VITOR OLIVEIRA MACEDO"
"JOÃO VICTOR OLIVEIRA"	"JOÃO VICTOR OLIVEIRA DA SILVA"
"NETINHO"	"JOÃO JOSÉ DE FARIA NETO"
"JOAO FABRICIO"	"JOAO FABRICIO NASCIMENTO"
"JOÃO CALLAÇA"	"JOÃO CALAÇA DA ROSA JÚNIOR"
"JOÃO DA SEGURANÇA"	"JOÃO BATISTA FERREIRA RIBEIRO"
"JOAO ALVES DE CARVALHO"	"JOAO ALVES DE CARVALHO"
"JOANA DA GRANJA PLANALTO"	"JOANA DARC QUEIROZ CURY"
"DONA JOANA"	"JOANA DA CONCEIÇÃO DE SOUZA GAMA"
"JOANA D ARC"	"JOANA D ARC FERREIRA"
"JEOVANE ALEX"	"JEOVANE ALEX FERRETE"
"JEFFERSON RANGEL"	"JEFFERSON RESENDE RANGEL"
"JEANE CARLA"	"JEANE CARLA TAVARES E SILVA"
"PIERRE ZAGO"	"JEAN PIERRE ZAGO"
"JARDEL FONTINNI"	"JARDEL ALVES PESSOA"
"JANINE ABRÃO"	"JANINE DE QUEIROZ DIAS ABRÃO POLO"
"JANE MEIRE"	"JANE MEIRE ROSA"
"JANAINA GUIMARÃES"	"JANAINA GUIMARAES PARREIRA REZENDE"
"SGT. JAIRO (JAIRÃO)"	"JAIRO JOSE RIBEIRO"
"SR. JAIRO CERQUEIRA"	"JAIRO ALEXANDRE DA SILVA CERQUEIRA"
"JAIR FERRAZ"	"JAIR CARNEIRO FERRAZ"
"J MARCOS"	"JAINATON MARCOS DE JESUS SILVA"
"JACQUE AIMÊ"	"JACQUELINE AIMÊ DOS REIS VILELA"
"PASTOR JACKSON FERREIRA"	"JACKSON FERREIRA DOS SANTOS"
"IVAN NUNES"	"IVAN DA SILVA NUNES"
"ISABELA SOLOGUREN"	"ISABELA JUNHO SOLOGUREN"
"CABO GARCIA"	"IRINEU VIEIRA GARCIA"
"PROFESSOR CIZINHO"	"IRACI JOSÉ DA SILVA FILHO"
"IORRANA JULLYCE"	"IORRANA JULLYCE SILVA"
"IOIO DO POVO PARA O POVO"	"IOHANY DOS SANTOS RAMOS"
"PROFESSORA LILI"	"ILEUZA AIRES DE SOUZA FELIPE"
"DR IGINO"	"IGINO MARCOS DA MATA DE OLIVEIRA"
"IARA AMARAL"	"IARA CRISTINA MACEDO AMARAL"
"HUGO COLETIVO RAIZ CERRATENSE"	"HUGO JOSÉ DE PAULA MARTINS ZAPAROLLI"
"HUDSON DO FERRO VELHO DO BIMBA"	"HUDSON BORGES LIMA"
"HENRIQUE RAFAEL"	"HENRIQUE DA SILVA RAFAEL"
"HENRIQUE BRUTUS"	"HENRIQUE APARECIDO CARVALHO DA SILVA"
"HELOIZA SANTANA"	"HELOIZA RODRIGUES SANTANA"
"HELIOMAR BOZO"	"HELIOMAR CANDIDO PEREIRA"
"HÉLIO JOSÉ"	"HELIO JOSÉ DE CARVALHO"
"NICE"	"HELENICE MARIA CARDOSO"
"HAROLDO NICOVER"	"HAROLDO CARDOSO SOARES"
"HARLEY MIRANDA"	"HARLEY LOURENCO DE MIRANDA"
"THIACA DO PLANALTO"	"HAMILTON DOS SANTOS"
"PROFESSORA HÁIDA"	"HAIDA VIVIANE PALHANO ARANTES"
"GUSTAVO SILVEIRA"	"GUSTAVO ROBERTO DE SOUZA"
"GUSTAVO AMARAL"	"GUSTAVO OLIVEIRA AMARAL"
"GUSTAVO MENEZES DA PATINAÇÃO"	"GUSTAVO MENEZES CARDOSO"
"DR GUSTAVO"	"GUSTAVO MARTINS DE SA"
"GUS"	"GUSTAVO HENRIQUE DE LIMA RIBEIRO"
"GUSTAVO GALASSI"	"GUSTAVO GALASSI GARGALHONE"
"PROFESSOR GUIMES"	"GUIMES RODRIGUES FILHO"
"DR. GUILHERME FREITAS"	"GUILHERME PINHEIRO DE FREITAS"
"LAMBERTINI"	"GUILHERME PEREIRA SILVA"
"GRAZI SANTANA"	"GRAZIELA SILVA SANTANA DOS REIS"
"GRAZIELLA DO FORRÓ"	"GRAZIELA DE OLIVEIRA SOARES SANZONE"
"GRACIELLE TEIXEIRA"	"GRACIELLE TEIXEIRA SILVA"
"GLEICIMAR CAVALCANTE"	"GLEICIMAR CAVALCANTE TELES"
"GLEICE MOREIRA A PRECIOSA"	"GLEICE GONÇALVES DO NASCIMENTO MOREIRA"
"GLÁUCIA DA SAÚDE"	"GLAUCIA GALANTE BUISSA"
"GISLAINE CAIXETA"	"GISLAINE CAIXETA DE QUEIROZ"
"GISELE OKUHARA"	"GISELE OKUHARA CAMPOS"
"GILVAN MASFERRER"	"GILVAN MASFERRER"
"GILSON DO POVO"	"GILSON EDUARDO ROSA"
"PASTOR GILMAR IPTG"	"GILMAR FAUSTO SANTOS"
"GILDÁSIO DE JESUS"	"GILDÁSIO DE JESUS OLIVEIRA"
"GILBERTO REZENDE"	"GILBERTO REZENDE SOBRINHO"
"GILBERTO CUNHA"	"GILBERTO ADENIÊ CUNHA"
"PROF GIANCARLO SOARES"	"GIANCARLO FERNANDES SOARES"
"GESSY GORDINHA DAS VERDURAS"	"GESSILENI DA SILVA DIAS"
"GERALDO MAGELA "	"GERALDO MAGELA GONÇALVES DORNELES"
"DR. GERALDO JABBUR"	"GERALDO JABBUR BRAGA"
"DR. GERALDO JABBUR"	"GERALDO JABBUR BRAGA"
"GERALDINHO DO SÃO JORGE"	"GERALDO CALIXTO"
"GERALDO BISPO"	"GERALDO BISPO PEREIRA"
"GEO DIAS"	"GEOVANIA DIAS DA COSTA"
"GINO PEIXE FRITO"	"GENIVALDO MACHADO SILVA"
"GASPAR DO SHOPPING PARK"	"GASPAR FONSECA DE REZENDE"
"GABI VITORINO"	"GABRIELA BARCELOS VITORINO"
"GABRIEL FOOD TRUCK"	"GABRIEL MARCELINO MIRANDA"
"FRED FISIOTERAPEUTA"	"FREDERICO BORGES URZEDO"
"FRANKMANY MEDEIROS"	"FRANKMANY MEDEIROS DE OLIVEIRA"
"FRANK DA GARAGEM"	"FRANK JANES FRANCISCO"
"FRANCYS FELISBERTO"	"FRANCYS FELISBERTO"
"CHICAO PERIFERIA"	"FRANCISCO RODRIGUES DA SILVA"
"TICO MARANHÃO"	"FRANCISCO DAS CHAGAS SANTOS BEZERRA"
"FRAN CLARA DA SAÚDE"	"FRANCIELLE CLARA TEIXEIRA"
"FRAN BILDEIRAS"	"FRANCIELE CUSTODIO ROSA"
"FLEXTONI"	"FLEXTONI FERNANDES RODRIGUES"
"FLÁVIO LIMA"	"FLAVIO PEREIRA DE LIMA"
"DR FLAVIO ADVOGADO"	"FLAVIO JOSE FERREIRA"
"FLAVIANO MARTINS"	"FLAVIANO MARTINS"
"FLÁVIA CARDOSO"	"FLAVIA REZENDE CARDOSO"
"FILIPPE BRITO"	"FILIPPE BRITO VENANCIO"
"FERNANDO FEIJÃO"	"FERNANDO MARIANO FERREIRA"
"BETÃO DO POVO"	"FELISBERTO PEREIRA DE SOUSA SOBRINHO"
"SGT FAUSTO ENFERMEIRO"	"FAUSTO RODRIGUES DE OLIVEIRA"
"FABÍOLA BENFICA"	"FABÍOLA BENFICA MARRA"
"MESTRE FABINHO"	"FABIO VLADIMIR SILVA"
"DR FABIO CRUVINEL"	"FABIO NUNES CRUVINEL"
"PR FABIO MENDES BIRIBA"	"FABIO MENDES DE SOUZA"
"FÁBIO DEPIN"	"FÁBIO GUILHERME DEPIN"
"FABÃO"	"FABIO DIAS QUEIROZ ZAVITOSKI"
"FABIANA MARTINS"	"FABIANA MARTINS DOS REIS"
"FABIANA MOURA"	"FABIANA DE MOURA ALVES"
"FABIANA DA BIANCA FLORES"	"FABIANA CAMARGO ALVES"
"FABIA DO JARDIM BRASÍLIA"	"FABIA MARA DA SILVA"
"EVELIN CARDOSO"	"EVELIN DE CASTRO CARDOSO"
"EVALDO CAIXETA"	"EVALDO GONCALVES CAIXETA"
"ERLI LAVA JATO"	"ERLI JOSE VAZ"
"ERIVAN MAGALHAES"	"ERIVAN MAGALHAES MORAES"
"ERI"	"ERIVALDO JOSE FERREIRA"
"SARGENTO ERIKA"	"ERIKA DESIREE OLIVEIRA SIMEÃO"
"GK"	"ENZO HENRIQUE GARCIA DE OLIVEIRA"
"ENEZIO"	"ENEZIO RODRIGUES DE SOUZA FILHO"
"ELTON PRATES"	"ELTON CÉSAR PRATES"
"ELOÍSA DO SOCIAL"	"ELOÍSA TELES DE ALMEIDA"
"ELINHO DA ACADEMIA"	"ELIUSMARCIO ALVES DE CARVALHO"
"BETE BETINHA"	"ELISABETH PEREIRA DA SILVA"
"BAIANO DO RADIADOR"	"ELIEZER SANTOS BELLO"
"ELIENE CHAVES"	"ELIENE CHAVES DE OLIVEIRA"
"ÉLICA BORBA"	"ÉLICA BORBA DA CONCEIÇÃO"
"ELIAS NUNES"	"ELIAS NUNES MOREIRA"
"MAESTRO ELIAS GOMES"	"ELIAS GOMES"
"ELIANE MONTE HEBROM"	"ELIANE QUINTINO DE LIMA DOS SANTOS"
"ELETÍCIA GOMES"	"ELETICIA GOMES DAS GRACAS"
"ELEODORO"	"ELEODORO NUNES BORGES"
"ELAINE NAVES"	"ELAINE CRISTINA VIEIRA NAVES DE SOUSA"
"EIDES CANIVETE"	"EIDES GONÇALVES EUGÊNIO DA SILVA"
"EDUARDO GREVÂNIAH"	"EDUARDO TEODORO ROCHA AZEVEDO"
"EDUARDO PALITO"	"EDUARDO RESENDE DE ARAÚJO"
"MILKEN"	"EDUARDO MILKEN"
"DUDU"	"EDUARDO MATEUS ALVES BORGES"
"EDUARDO ELIAS"	"EDUARDO ELIAS DE LIMA"
"EDUARDO MORAES"	"EDUARDO BORGES MORAES"
"EDINHO COMBATE AO CÂNCER"	"EDSON CARVALHO FERREIRA"
"SGT EDNALDO"	"EDNALDO RÉGIO DE LIMA"
"PROFESSORA EDNA IDE"	"EDNA LUIZA BULGARELLI IDE"
"NEGO VELHO"	"EDIVALDO ALVES FERREIRA"
"CANTOR EDELVAN CAMPOS"	"EDELVAN CAMPOS ARAÚJO"
"PROFESSOR EDEILSON"	"EDEILSON PEREIRA DA SILVA"
"EBINHO"	"EBER CAIXETA DE CARVALHO"
"DIVINO TADEU"	"DIVINO TADEU NASCIMENTO"
"DIORDEN E PROGRESSO"	"DIORDEN DIOFFTTO PAIVA DA SILVA"
"DOLAR ATLETA PARALÍMPICO"	"DIONILO CÂNDIDO FILHO"
"DIONE LOPES"	"DIONE LOPES FERNANDES"
"DIOGO DA SUNCRED"	"DIOGO DA SILVA FERNANDES"
"DIOGENES JUNIOR"	"DIOGENES NUNES DA COSTA JUNIOR"
"DENISE MELO"	"DENISE BATISTA DE MELO"
"DENILSON PROTÉTICO"	"DENILSON GONÇALVES DA SILVA"
"PROFESSORA DELMA"	"DELMA INÁCIA MACEDO"
"DELFINO"	"DELFINO EURÍPEDES MARQUES RODRIGUES"
"DEINER LUIZ"	"DEINER LUIZ OLIVEIRA"
"DEBORA TANO"	"DEBORA PAULA TANO MARTINS"
"DÉBORA MENEZES"	"DÉBORA MENEZES ESPIR"
"DANILLO DO VALE"	"DAVID SOARES FRUTUOSO"
"DAVI LANCASTRE"	"DAVI VICTOR MACIEL DA SILVA"
"DARU AMARAL"	"DARUANY AMARAL MARTINS"
"DAPHINY PRETA"	"DAPHINY OLIVEIRA COSTA SILVA"
"DANUBIO"	"DANUBIO MARQUEZ ANDRADE"
"DANNY PAOLLO  ARRUDA"	"DANNY PAOLLO LEITE DE ARRUDA"
"DANILO LOPES"	"DANILO RODRIGUES LOPES"
"DANIEL MATOS"	"DANIEL MATOS DA SILVA"
"DANIEL PNEUS"	"DANIEL HEBERTE SILVA"
"DANIEL DO ÔNIBUS"	"DANIEL EDUARDO DA SILVA"
"AGENTE SILVA"	"DANIEL DA SILVA"
"DANDARA"	"DANDARA TONANTZIN SILVA CASTRO"
"DAIRA SAMPAIO"	"DAIRA KELI SAMPAIO"
"CUSTODIO DAMASCENO"	"CUSTODIO TEIXEIRA DAMASCENO"
"CRISTIANO SILVA"	"CRISTIANO RODRIGUES DA SILVA"
"MAGRAO"	"CRISTIANO LUIZ DE SOUZA"
"PROFESSOR CONRADO AUGUSTO"	"CONRADO AUGUSTO FERREIRA DE OLIVEIRA"
"CLEUSA TERAPEUTA"	"CLEUSA MARIA DA CUNHA"
"PROF CLÉRIA"	"CLÉRIA MARIA COUTO DE SOUZA RODRIGUES"
"CLENIZE COELHO"	"CLENIZE DAS GRACAS COELHO RESENDE BORGES"
"CLEBÃO DO POVO"	"CLEBER LAMARTINE GUIMARÃES"
"CLEITINHO CAPIAU"	"CLAYTON PEIXOTO DA CUNHA"
"ZIM BORRACHEIRO"	"CLAUDNE BATISTA ALVES"
"CLAUDINHO DO AÇAÍ"	"CLAUDIONOR CARLOS"
"CLAUDIO PEREIRA"	"CLAUDIO PEREIRA"
"BETÃO LUIZOTE"	"CLAUDIO HUMBERTO LINO"
"PROFESSOR CLÁUDIO"	"CLAUDIO DE ALMEIDA FERNANDES"
"CLAUDINHO É DO POVO"	"CLAUDIO ADRIANO DA COSTA ROSA"
"PROFESSOR CLAUDINEY"	"CLAUDINEY DO NASCIMENTO"
"CLÁUDIA GUERRA"	"CLÁUDIA COSTA GUERRA"
"CLAUBIA DA SAÚDE"	"CLAUBIA JULIO OLIVEIRA"
"CLARICE DO MORADA NOVA"	"CLARICE DE FÁTIMA DANTAS"
"CLARA DO DOM"	"CLARAMILA SILVA SANTOS"
"CLARA TRANSPARENTE"	"CLARA LUCIA DE ANDRADE"
"CELSO PAPAI NOEL"	"CELSO DE SOUSA"
"CHICÃO"	"CELSO ARANTES MARTINS"
"PEZÃO DO ESPORTE"	"CELISVALDO DA SILVA"
"CÉLIO LACERDA"	"CÉLIO LACERDA MENDONÇA"
"CELIM DO PATRIMÔNIO"	"CELIO JOSÉ DA SILVA"
"CÉLIO ÚLTIMO GOLE"	"CÉLIO EUSTAQUIO DA SILVA"
"CÉLIA SANTOS"	"CELIA DOS SANTOS"
"CATHERINE NAGHETTINI"	"CATHERINE NAGHETTINI"
"CASSIM"	"CÁSSIO EDUARDO RODRIGUES DA SILVA"
"CASSIANA BRUNETTO"	"CASSIANA BRUNETTO SPACEK"
"CARMITA QUIRINO"	"CARMITA DIVINA QUIRINO"
"EDUARDO NOVAES"	"CARLOS EDUARDO NOVAES"
"SARGENTO CARLOS FONSECA"	"CARLOS EDUARDO FONSECA"
"KAKI CARTEIRO"	"CARLOS ANTONIO RIBEIRO"
"CARITA ALVES"	"CARITA ALVES DE MOURA LOPES"
"CACILDA FLORENTINO"	"CACILDA FLORENTINO DE ANDRADE"
"CACIA VIEIRA"	"CACIA MIRIAN NUNES VIEIRA"
"BRUNÃO CICLISTA"	"BRUNO RAFAEL SILVA MEDEIROS"
"BRUNINHO DO POVO"	"BRUNO PEREIRA"
"FLORENTINO TOP 10"	"BRUNO CAMARGOS DIAS"
"BRAULIO MARCOS"	"BRAULIO MARCOS CARDOSO ALVES"
"BLENINHO"	"BLENER DE SOUZA FERREIRA SILVA"
"BIA DA ACADEMIA"	"BIA CARLA BORGES FREITAS"
"BERNADETE LINO "	"BERNADETE LINO DA SILVA"
"BÁRBARA NOGUEIRA"	"BÁRBARA SILVA NOGUEIRA"
"LERO NUNES"	"AURETIANO NUNES MOREIRA"
"TIGRÃO"	"AUGUSTO CÉZAR GOMES RIBEIRO"
"ARTHUR FERREIRA"	"ARTHUR LUIZ FERREIRA"
"ARNALDO CARECA"	"ARNALDO DE LIMA FILHO"
"ARENO"	"ARENO DE OLIVEIRA"
"TIA CIDA"	"APARECIDA PEREIRA DOS SANTOS ALMEIDA"
"CIDA MAGALHÃES"	"APARECIDA MARTINS MAGALHÃES"
"CIDA FRANCO"	"APARECIDA DE FATIMA FRANCO MOTA"
"TONINHO DA MEDICINA"	"ANTÔNIO VENÂNCIO FERREIRA NETO"
"TONY ELETRÔNICO FOTÓGRAFO"	"ANTÔNIO JOSÉ DE ARAÚJO MENDES"
"CARRIJO"	"ANTÔNIO CARLOS CARRIJO"
"ANTÔNIO AUGUSTO QUEIJINHO"	"ANTÔNIO AUGUSTO GONÇALVES GOULART"
"ANTÔNIA OLIVEIRA"	"ANTONIA APARECIDA CONCEICAO DE OLIVEIRA COSTA"
"ANNA REIS"	"ANNA PAULA DA SILVA REIS"
"DOMINIC TORETTO"	"ANGELO COSTA SOARES"
"ANGELICA BARROS"	"ANGELICA TAVARES DE BARROS"
"ANGELA DO POSTINHO"	"ANGELA APARECIDA CAETANO SOUZA"
"ÁNDREIA FREITAS"	"ANDREIA CRISTINA DE FREITAS PASSOS DE OLIVEIRA"
"ANDRE PROTETOR"	"ANDRE LUIZ MENDES"
"TIO ANDRÉ"	"ANDRE LUIZ FURTADO EVANGELISTA"
"ANDRE MALAQUIAS"	"ANDRE LUIS MALAQUIAS"
"ANDRÉ TRUCKANDO"	"ANDRÉ JANSSON"
"ANDRÉ OMENA"	"ANDRÉ AMARAL DE OMENA"
"ANDERSON BOLA "	"ANDERSON SILVA DE LIMA"
"ANDERSON LIMA"	"ANDERSON LIMA DA SILVA"
"ANA RITA DA SAÚDE"	"ANA RITA DE FARIA"
"PAULA FIDEL"	"ANA PAULA FERREIRA ARRUDA SANTOS"
"PATRICIA MIRANDA"	"ANA PATRICIA GONÇALVES MIRANDA"
"DIRETORA ANA MARIA"	"ANA MARIA DE FREITAS"
"ANA LARISSA GUEDES"	"ANA LARISSA SANTOS GUEDES"
"ENGENHEIRA ANA FLÁVIA"	"ANA FLÁVIA MEDEIROS"
"ANA"	"ANA CRISTINA PORFIRIO RIBEIRO"
"ANA FRONTAROLLI"	"ANA CLAUDIA FRONTAROLLI"
"CAROL MARTINS"	"ANA CAROLINA SILVEIRA MARTINS"
"CAROL JACOB"	"ANA CAROLINA JACOB DA CRUZ"
"AMAURY ALVES"	"AMAURY ALVES DA SILVA"
"AMANDA GONDIM"	"AMANDA THAYLASSA GONDIM FERREIRA"
"AMANDA ALVES"	"AMANDA ALVES DOS SANTOS"
"AMADO JÚNIOR"	"AMADO DA SILVA NUNES JÚNIOR"
"LUIZINHO DO BARRETO"	"ALUISIO ANTONIO QUEIROZ"
"ALTTAIR ALVES"	"ALTTAIR ALVES DE OLIVEIRA"
"ALINE CONSULTORA IMOBILIARIA"	"ALINE SOUZA BRITO"
"ALINE SOARES"	"ALINE SOARES DA COSTA"
"ALFREDO NETO"	"ALFREDO DIAS BERNARDES NETO"
"ALEX PÉROLA"	"ALEXSANDER RUFINO BORGES"
"ALEXANDRE DO ESPETINHO"	"ALEXANDRE LUIZ DOS SANTOS"
"XANDÃO DO AFTER"	"ALEXANDRE DONIZETTI DE SOUZA"
"ALEXANDRA SARDELLA"	"ALEXANDRA DA ROCHA SARDELLA"
"ALEX"	"ALEX SANDRO RODRIGUES MORAES"
"ALENIR DA FARMACIA"	"ALENIR RODRIGUES XAVIER"
"MAKALÉ"	"ALAN CARLOS SILVA"
"AIRTON PINHAL"	"AIRTON DE OLIVEIRA PINHAL"
"AGNALDO BLADILEI"	"AGNALDO SOARES DE SOUSA"
"AGUINALDO MARQUES SERVIDOR"	"AGNALDO MARQUES PEREIRA"
"ADRIANO ZAGO"	"ADRIANO ZAGO"
"ADRIANO FUTSAL"	"ADRIANO SANTOS"
"ADRIANA MARIA"	"ADRIANA MARIA DA SILVA"
"GELEIA DA BICICLETARIA"	"ADILSON LUIZ DOS SANTOS"
"ADICIONALDO"	"ADICIONALDO DOS REIS CARDOSO"
"ADEMILSON MARQUES"	"ADEMILSON MARQUES MOREIRA"
"ACACIO PONTES"	"ACACIO RIBEIRO DA SILVA PONTES"
"ABATENIO"	"ABATENIO DE ANDRADE MARQUEZ NETO"
"ROSÁRIA RODRIGUES "	"ABADIA ROSARIA DE CASTRO RODRIGUES"

3)

SELECT nm_candidato
FROM candidato
WHERE dt_nascimento < '01/01/1954' AND sg_uf = 'AC'

"AGMAR LOPES DE SOUZA"
"RAIMUNDO SOUZA DOS SANTOS"
"FRANCISCO VAZ MAGALHÃES"
"FRANCISCA ALVES DE OLIVEIRA"
"FRANCIMAR FERNANDES DE ALBUQUERQUE"
"LUIS CELSO DAS CHAGAS MOURÃO"
"JAIRO CASTRO DA PENHA"
"JOSE TEODORO DE SOUZA"
"EDNON MOREIRA SOARES"
"SEBASTIAO BOCALOM RODRIGUES"
"MANOEL DE LIMA SOARES"
"VICTOR YSMAEL CANDIA CUSICANQUI"
"AROLDO MONTEIRO RODRIGUES"

4)

SELECT nm_urna_candidato
FROM candidato
WHERE nm_urna_candidato LIKE '%LULA%' OR nm_urna_candidato LIKE '%BOLSONARO%'

"GASPAR CELULAR"
"LULA FOTO"
"ROGERIO RR CELULARES"
"LULA DE JANJÃO"
"PROFESSOR LULA"
"RAQUEL DA CELULARES"
"LULA DE CHINA"
"NEGÃO DO CELULAR"
"DUDU CELULAR"
"LUCIANO DO CELULAR"
"LULA DO ESPORTE"
"MAURICIO DO CELULAR"
"DJANIRA LULA"
"LULA DO ALECRIM"
"GERSON PERSCH (LULA)"
"NEGUINHO CELULAR"
"TONINHO BOLSONARO"
"JOSUEL DO LULA"
"JAILSON CELULAR"
"LUCAS DO CELULAR"
"BINHO CELULARES"
"LÉO BOLSONARO"
"ZEZINHO DO CELULAR"
"LULA DA FARMACIA"
"GALEGO CELULAR"
"LUCIANO LULA"
"MARQUINHO DO CELULAR"
"EVILÁSIO INÁCIO BOLSONARO"
"WELLINGTON DO CELULAR"
"RENATO DO LULA"
"CLAUDIO DO CELULAR"
"SIDNEI BOLSONARO"
"LULA"
"JOSE MARIO PA PRESIDENTE LULA"
"LULA DA XAVIER"
"LULA DA MURITIBA"
"RENATO BOLSONARO"
"MARCOS DA FABIANA BOLSONARO"
"EDIVALDO LULA DA OFICINA"
"WAGNER GORDINHO DO CELULAR"
"LULA DE MAUES"
"ZE DO LULA"
"LULA BRAVO"
"ARLINDO CELULARES"
"JULIANA DE LULA"
"DR LULA"
"GILSON CELULARES "
"ADEVILSON BOLSONARO"
"LULA DA 40"
"SERGITO CELULAR"
"ANDRÉ BOLSONARO"
"LULA PRETO"
"GUI CELULARES"
"SAMANTA BOLSONARO"
"ISAIAS DO CELULAR"
"VINICIUS LULALIVRE"
"MÁRCIO CELULAR"
"FÃO DO BOLSONARO"
"ROGERIO CELULAR"
"LULA DO ASSENTAMENTO"
"BULLI DA VIVI CELULARES"
"LUCAS DO CELULAR"
"RAMON DO CELULAR"
"BOLSONARO SERGIPANO"
"RENATA DE LULA"
"NENÉM DO LULA"
"LINDOMAR DO LULA"
"LULA TEIXEIRA"
"FELIPE BOLSONARO"
"JUNIOR BOLSONARO"
"GERALDINHO BOLSONARO"
"EDSON CELULAR"
"LULA BONDADE"
"VALDIVAN CASA DO CELULAR"
"GERALDO LULA"
"MARCELO BOLSONARO"
"RENATA BOLSONARO"
"CLAUDIO LULA"
"CHAGUINHA CELULAR"
"VINI CELULAR"
"LULA DO ASSENTAMENTO"
"JULIANO CELULARES"
"LULA"
"BOLSONARO DE MIRANORTE"
"LULA LIMA"
"RONALDO BOLSONARO"
"LULA RIBEIRO"
"LULA"
"PAULINHO DO CELULAR"
"CARLOS PULULA"
"DILSON DO CELULAR"
"ROBSON DO CELULAR"
"MESSIAS E COLETIVO DO LULA"
"PROFESSOR LULA"
"IRMÃO LULA DE PINDOBAL"
"LULA DO SALÃO"
"ROGERIO GOMES CASA DO CELULAR"
"FABI DO NOEL CELULARES"
"ZÉ DE LULA"
"LULA"
"CARLINLULA"
"LULA PEDREIRO"
"LULA"
"LUIZA DE LULA"
"LUCIANO CELULAR"
"FREITAS CELULAR"
"EDSON LULA"
"CLAUDIA  BOLSONARO"
"RENATO MEGA CELULAR"
"LULA DE ARAPIRACA"
"LULA DE CAPANEMA"
"LULA"
"RAFA APOIADORES DO BOLSONARO"
"LULA DO GESSO"
"CALANGO CELULAR"
"LUIZINHO DE LULA"
"BOLSONARO"
"LULA COZER"
"DR LULA"
"EVY LULA DA SILVA"
"PROFESSORA MARTA LULA "
"JESSE LULA"
"LULA DO ARIADO"
"LULA DA AMBULÂNCIA "
"MARIA BOLSONARO"
"PRATES BOLSONARO"
"VENÂNCIO DA JUNINHO CELULARES"
"LAURI LULA"
"WILLYAN CELULAR"
"LULA DO BREJO"
"IR LULA DO AR CONDICIONADO"
"LULA CAVALGADA"
"LUIS FRANCISCO LULA"
"GIL DO CELULAR"
"LULA DO ARMAZÉM"
"LULA"
"LULA TÔRRES E PAULINHO"
"DAVI DO CELULAR"
"ROSELI BOLSONARO"
"WANDER DO CELULAR"
"LULA DO MORRO GRANDE"
"SILVIO BOLSONARO"
"PROF LULA"
"LULA NEGÃO "
"MARCOS CELULAR"
"LULA SANTA JOANA"
"QUERIDA BOLSONARO"
"JAQUELINE DO PAULO CELULARES"
"AMAURY DE LULA"
"MARCIEL DO CELULAR"
"EDSON CELULAR"
"LULA DO NETÃO"
"LULA DA ESTIVA"
"LULA DO DOCE"
"LULA"
"BOLSONARO"
"RODRIGO CELULAR"
"AMANDA BOLSONARO"
"LISI BOLSONARO"
"LULA DA CACHAÇA"
"JONATHAN DE LULA"
"LULA DO QUIOSQUE"
"LULA ELETRICISTA"
"PAULINHO CELULAR"
"LULA DO POVO"
"JOANY DOTE BOLSONARO"
"JUNIOR DO CELULAR"
"PAULINHO CELULAR"
"GERSON DO CELULAR"
"LULA"
"JAMILLY DE LULA DO TRANSPORTE"
"ALEXANDRE ARS CELULARES"
"ELVIS DO CELULAR"
"LOIRA DO CELULAR"
"LULA MOREIRA"
"DITO LULA "
"AURICELIA DO LULA-AGORA É NÓS"
"LULA CABRAL"
"LULA BRANDÃO"
"LUCIMARA DO LULA"
"LULA"
"JEAN BOLSONARO"
"LULA BRASIL"
"LULA DA TAPIOCA"
"NEIDE DE LULA "
"LULA MEDEIROS"
"NEIA DE LULA"
"UANDERSON SHOP DO CELULAR"
"ADRIANO CELULARES"
"RATINHO MECANICO BOLSONARO"
"SANDRO DE LULA"
"LULA"
"MARCELO DO CELULAR"
"DANILO BOLSONARO"
"KELLE DE LULA"
"CARLINHOS DO CELULAR"
"LULA DA DIREITA"
"LULA MACIEL"
"KARYNE DO JOAB CELULARES"
"IRMAO LULA "
"LULA DO YAMAZATU"
"NÊGO CELULAR"
"CRISTIANO BOLSONARO"
"IVAN BOLSONARO"
"LULA"
"JOAOZINHO CELULAR"
"WALQUE DO CELULAR"
"JEFINHO DO CELULAR"
"TONHO CELULAR"
"JUNINHO CELULARES"
"MILTON BOLSONARO"
"LULA"
"LULA DE SÃO JOÃO"
"MARCELO DO CELULAR"
"ÍNDIO DO CELULAR"
"LULA LIVRE"
"EDNA DE LULA DO BANCO"
"DAMASIO CELULARES"
"LULA DE CACA"
"MAX ALEX CELULAR"
"EDER CELULAR"
"ISRAEL DA VIP CELULAR"
"LULA COSTA"
"LULA MERITI"
"ZECA BOLSONARO"
"ZEZITO CELULARES"
"SUELY BOLSONARO"
"LULA DA SERRA"
"NIVALDO DO CELULAR"
"LULA PRATA"
"JOSE BOLSONARO"
"JUNIOR CELULAR"
"LULA SOUTO COLETIVO LUTA BELÉM"
"ROSILDA DE LULA PADRE"
"MARCIO CELULARES"
"LULA DO SUMIDOURO"
"LULA"
"ERIVELTON LULA"
"RAFAEL DO CELULAR"
"DR RAIZ LULA DE MARCOS MOURA"
"MARCELO DO CELULAR"
"VICTOR DA OFICINA DO CELULAR"
"SARA BOLSONARO"
"LULINHA DE LULA"
"TIÃO LULA"
"RAMALHO CELULAR"
"LÉO DO CELULAR"
"CASSIO DA GABRIEL CELULAR"
"LULA VÉRAS"
"KEL CELULARES"
"EDILSON BOLSONARO"
"PROFESSOR ADAHILTON LULA"
"WILSON CELULAR"
"PEPA CELULAR"
"JEFESSON CELULAR"
"GUILHERME DO CELULAR"
"LOPES DO CELULAR"
"JOSÉ DARMI LULA"
"CARLOS BOLSONARO"
"MOURA DO CELULAR"
"MADUREIRA DO CELULAR"
"JHOW CELULAR"
"ROSALIA DO DR CELULAR"
"JERY CELULARES"
"HERCULANO BOLSONARO"
"LULA DE GERALDO PEDRO"
"TADEU MEGA CELULAR"
"ZECA CELULAR"
"LULA"
"ALCINEI DO CELULAR"
"REINALDO BOLSONARO"
"LULA DO AÇOUGUE"
"LULA DO LAZERÃO"
"EDGAR DO CELULAR"
"LULA BILHETEIRO"
"LULA DO BESSA"
"WELLINGTON DO CELULAR"
"LULA O AMIGO DE SEMPRE"
"BOLSONARO DE ARAÇOIABA"
"MARCELO DO CELULAR"
"FERNANDA DA LULA"
"LULA"
"BATISTA DA LOJA DE CELULAR"
"DEDÉ DE LULA"
"IRMÃO GUSTAVO DE LULA"
"UELINTON DO CELULAR"
"LULA"
"WINTER BOLSONARO"
"LULA CORDEIRO"
"LULA"
"JORGINHO DO CELULAR"
"CÉLIO CELULARES"
"CHARLES CELULARES"
"NALDO CELULAR"
"KIKA CELULARES"
"LULA DO ÔNIBUS"
"CLAUDIA BOLSONARO"
"ARMANDO BOLSONARO"
"MARCELO CELULAR"
"LULA DA CADEIRINHA"
"ALINE LOJA CELULAR"
"GABRIEL DO CELULAR"
"DJACI DO CELULAR"
"LULA DO DOIS DE JULHO"
"ADRIANO CELULAR"
"GARGAMEL BOLSONARO"
"XANDE CELULAR"
"PALOMA DE LULA"
"MARCELA DO LULA"
"KINHA DE LULA"
"PROFESSOR JOSENILDO LULA"
"JAIR BOLSONARO"
"DEILSON BOLSONARO"
"LULA DO BRITADOR"
"LULA LEÃO"
"LULA CANUTO"
"LULA DE PITANGA"
"CAROL DO EUSTAQUIO CELULAR"
"ODILON BOLSONARO"
"FABINHO DO CELULAR"
"LULA"
"LULA"
"JUNIOR CELULAR"
"LUIZ CARLOS LULA SOARES"
"JOEL BOLSONARO"
"LULA DE ZE PINTO"
"LULA DO NARINHO"
"LULA"
"LULA BARROS"
"EDSON CELULARES"
"RAILSON DO CELULAR"
"LULA PINTOR"
"NEGÃO DO CELULAR"
"CARLOS BOLSONARO"
"JARBAS BOLSONARO"
"EVANDRO DO CELULAR"
"LULA RODRIGUES"
"LULA LOPES"
"LULA PONCE"
"JOHNNY DO CELULAR"
"NIVALDO DO CELULAR"
"LULA DE DÃO"
"LULA LOPES"
"EDILAN DO CELULAR"
"FELIPE BOLSONARO"

5)

SELECT can.nm_candidato, gr.ds_grau_instrucao
FROM candidato can, grau_instrucao gr
WHERE can.nm_ue = 'CASA BRANCA' AND can.sg_uf = 'SP'

"ADENILSON VICENTE"	"NÃO DIVULGÁVEL"
"MARCOS ANTONIO MONTEIRO"	"NÃO DIVULGÁVEL"
"FRANCIS MARA DE OLIVEIRA DA SILVA"	"NÃO DIVULGÁVEL"
"HELAINE CRISTINA BACAN RAMOS"	"NÃO DIVULGÁVEL"
"BEATRIZ PISTELLI"	"NÃO DIVULGÁVEL"
"MARINA CRISTINA ROBERTO"	"NÃO DIVULGÁVEL"
"DAMARIS FERNANDA RODRIGUES"	"NÃO DIVULGÁVEL"
"RODRIGO VENTALI CANATTO"	"NÃO DIVULGÁVEL"
"PAULO CESAR MORELLI SALOTTI"	"NÃO DIVULGÁVEL"
"MARCIA CARDOSO"	"NÃO DIVULGÁVEL"
"MATHEUS OSWALDO BARBOSA"	"NÃO DIVULGÁVEL"
"VALDECIR GABRIEL"	"NÃO DIVULGÁVEL"
"AMELIA FERNANDA VIANA DE MORAES"	"NÃO DIVULGÁVEL"
"FLAVIO ASTOLFI CAETANO NICO"	"NÃO DIVULGÁVEL"
"MARTA GONÇALVES"	"NÃO DIVULGÁVEL"
"LEANDRO JOSÉ DA SILVA"	"NÃO DIVULGÁVEL"
"RILDO APARECIDO DIAS"	"NÃO DIVULGÁVEL"
"PAULO ROBERTO BARATELLI"	"NÃO DIVULGÁVEL"
"LAERCIO RAYMUNDO DOS SANTOS"	"NÃO DIVULGÁVEL"
"LUCAS GABRIEL LEITE"	"NÃO DIVULGÁVEL"
"JOSE HENRIQUE GENARI"	"NÃO DIVULGÁVEL"
"LEANDRO BARBOZA DA SILVA"	"NÃO DIVULGÁVEL"
"FRANCISCO AFONSO GONGORA"	"NÃO DIVULGÁVEL"
"LUIZ MORATO MENDES"	"NÃO DIVULGÁVEL"
"RAFAELA ROGÉRIO PIO COLOMBINI"	"NÃO DIVULGÁVEL"
"MARCELO GALANTE LOPES DA CUNHA"	"NÃO DIVULGÁVEL"
"ANTÔNIO BENEDITO FERREIRA"	"NÃO DIVULGÁVEL"
"JOSÉ CLAUDIO MARTINS DOS REIS"	"NÃO DIVULGÁVEL"
"CHRYSLER THIAGO DE AZEVEDO"	"NÃO DIVULGÁVEL"
"TANIA MARA VENTURA"	"NÃO DIVULGÁVEL"
"MARCO AURÉLIO DA SILVA"	"NÃO DIVULGÁVEL"
"ANTONIO FRANCISCO SERAFIM"	"NÃO DIVULGÁVEL"
"MARCOS ANTONIO RODRIGUES"	"NÃO DIVULGÁVEL"
"LÍDIA JULIANA DE SOUZA"	"NÃO DIVULGÁVEL"
"ELVIS ALEXANDRE RODRIGUES"	"NÃO DIVULGÁVEL"
"THIAGO LOPES DAMACENO"	"NÃO DIVULGÁVEL"
"CRIS MARSSELY CARVALHO SILVA SANTIAGO"	"NÃO DIVULGÁVEL"
"FABIO JOSÉ ANDRADE DOS REIS"	"NÃO DIVULGÁVEL"
"WANDERSON LUIS TELLES"	"NÃO DIVULGÁVEL"
"EMERSON LUIS DA SILVA RODRIGUES"	"NÃO DIVULGÁVEL"
"LAEDIR EUGENIO DELFINO"	"NÃO DIVULGÁVEL"
"NÉLIO RICARDO DE OLIVEIRA"	"NÃO DIVULGÁVEL"
"JULIO ANDERSON GRESPAN DIAS"	"NÃO DIVULGÁVEL"
"LUAN CARLOS DE PAIVA NOGUEIRA"	"NÃO DIVULGÁVEL"
"EVALDO PINHEIRO DOS SANTOS"	"NÃO DIVULGÁVEL"
"CARINA MARQUES ALVES"	"NÃO DIVULGÁVEL"
"ANAIDE ALVES BREGA"	"NÃO DIVULGÁVEL"
"MARCIO LUIS SABAINI"	"NÃO DIVULGÁVEL"
"JOSE ROBERTO SATI"	"NÃO DIVULGÁVEL"
"STELA MARIA MENEGATO BACCI"	"NÃO DIVULGÁVEL"
"MURILO ANTONIALLI GIORDAN"	"NÃO DIVULGÁVEL"
"NADIA MARA GOMES ROSSETTO"	"NÃO DIVULGÁVEL"
"CRISTIANO HENRIQUE MORENO BENTO"	"NÃO DIVULGÁVEL"
"ADRIANA DONIZETTI DOS SANTOS FANTIM"	"NÃO DIVULGÁVEL"
"DANIEL ABRAÃO SOARES MECHILÃO"	"NÃO DIVULGÁVEL"
"MARLENE REZENDE DE SOUSA"	"NÃO DIVULGÁVEL"
"SONIA REGINA PASSOS RIBEIRO"	"NÃO DIVULGÁVEL"
"LUCIA REGINA PAULO RAMOS"	"NÃO DIVULGÁVEL"
"JULIO CESAR AMANCIO DA SILVA"	"NÃO DIVULGÁVEL"
"BRUNA LETICIA BERNARDO MARINGOLO"	"NÃO DIVULGÁVEL"
"ROSANA LÚCIA DE PAULA STRAZZA"	"NÃO DIVULGÁVEL"
"JOSELAINE DIAS MACHADO"	"NÃO DIVULGÁVEL"
"LEANDRO CORNETA DA SILVA"	"NÃO DIVULGÁVEL"
"VALTER TORRES RIBEIRO"	"NÃO DIVULGÁVEL"
"CARLOS AUGUSTO DA COSTA PIRES TESCH"	"NÃO DIVULGÁVEL"
"MARCELO DE ARAUJO PEREIRA"	"NÃO DIVULGÁVEL"
"MARIA FERNANDA DA SILVA BUZATTO"	"NÃO DIVULGÁVEL"
"OSCAR BAGNATORI JUNIOR"	"NÃO DIVULGÁVEL"
"EVAIR SERRACINI DA COSTA"	"NÃO DIVULGÁVEL"
"LUCIA HELENA BARBOSA PANSANI"	"NÃO DIVULGÁVEL"
"JOSÉ AUGUSTO SAVEGNAGO"	"NÃO DIVULGÁVEL"
"JOSE RODRIGUES CARVALHEIRO NETO"	"NÃO DIVULGÁVEL"
"LEDA BELITARDO DE OLIVEIRA"	"NÃO DIVULGÁVEL"
"REINALDO VENTAVOLI"	"NÃO DIVULGÁVEL"
"FABIO SANDOVAL"	"NÃO DIVULGÁVEL"
"IVONE PEDROSO DE MORAES ASSALIN"	"NÃO DIVULGÁVEL"
"JOSE GERALDO COLOMBINI"	"NÃO DIVULGÁVEL"
"DAIANA ROBERTA DOS SANTOS PIMENTA"	"NÃO DIVULGÁVEL"
"SERGIO LUIZ DE OLIVEIRA"	"NÃO DIVULGÁVEL"
"RENATO BARALDI ROMANO"	"NÃO DIVULGÁVEL"
"MARCUS VINICIUS PARENTE QUERIDO AZEVEDO"	"NÃO DIVULGÁVEL"
"ANDREA MARIA VIANA"	"NÃO DIVULGÁVEL"
"ANTÔNIO JOSÉ DA SILVA LISBÔA"	"NÃO DIVULGÁVEL"
"VALÉRIA DA SILVA LOPES"	"NÃO DIVULGÁVEL"
"ACACIO SERGIO RIBEIRO SILVA"	"NÃO DIVULGÁVEL"
"LUZ MARINA DE OLIVEIRA COSTA DE ANDRADE"	"NÃO DIVULGÁVEL"
"JESSICA QUALIA DOS SANTOS OLIVEIRA ROMUALDO"	"NÃO DIVULGÁVEL"
"ANTONIO CARLOS AMADEU"	"NÃO DIVULGÁVEL"
"CARLOS ALBERTO SANTA ROSA FILHO"	"NÃO DIVULGÁVEL"
"JOSE ARAUJO FILHO"	"NÃO DIVULGÁVEL"
"JULIANA FERREIRA MAGNABOSCO"	"NÃO DIVULGÁVEL"
"BEATRIZ HELENA ROSA"	"NÃO DIVULGÁVEL"
"SILVIA HELENA FRANCISCO FREITAS"	"NÃO DIVULGÁVEL"
"CARLOS ANDRÉ CASALLI"	"NÃO DIVULGÁVEL"
"ALBERTO ZOGBI FILHO"	"NÃO DIVULGÁVEL"
"SILVIA MARIA PALHARES MUSSI"	"NÃO DIVULGÁVEL"
"ANTONIO DONIZETE MARCELINO"	"NÃO DIVULGÁVEL"
"CARLA ROBERTA NOGUEIRA"	"NÃO DIVULGÁVEL"
"ELIANE CRISTINA CASTELANI DA SILVA"	"NÃO DIVULGÁVEL"
"NILSON DAS NEVES RODRIGUES JUNIOR"	"NÃO DIVULGÁVEL"
"LUIZ GUSTAVO RONCHI DOS SANTOS"	"NÃO DIVULGÁVEL"
"LUCIANO APARECIDO CANDIDO"	"NÃO DIVULGÁVEL"
"ANTONIO CARLOS DE OLIVEIRA"	"NÃO DIVULGÁVEL"
"ADILSON DE CAMPOS SALES"	"NÃO DIVULGÁVEL"
"LUCAS SILVA DE FREITAS"	"NÃO DIVULGÁVEL"
"RONALDO ADRIANO COELHO DE BRITTO"	"NÃO DIVULGÁVEL"
"FLAVIO BALBINO"	"NÃO DIVULGÁVEL"
"ALTOMIR BERNARDO DA SILVA"	"NÃO DIVULGÁVEL"
"DAIANA MARA BAPTISTA"	"NÃO DIVULGÁVEL"
"DEISE GILABERTI SANTIAGO SANTOS"	"NÃO DIVULGÁVEL"
"GUSTAVO MAXIMIANO RODRIGUES DE OLIVEIRA"	"NÃO DIVULGÁVEL"
"ANTONIO EDUARDO MARÇON NOGUEIRA"	"NÃO DIVULGÁVEL"
"JOSÉ ANDERSON PEREIRA DOS SANTOS"	"NÃO DIVULGÁVEL"
"GABRIELA CASTILHO GONÇALVES DE OLIVEIRA"	"NÃO DIVULGÁVEL"
"WILLIAN ROMEIRO CALIXTO"	"NÃO DIVULGÁVEL"
"EURICO SASSI FILHO"	"NÃO DIVULGÁVEL"
"PAULINO TREVISAN"	"NÃO DIVULGÁVEL"
"KARINA APARECIDA DE SOUSA SILVA TODERO"	"NÃO DIVULGÁVEL"
"ROQUE CIACO NETO"	"NÃO DIVULGÁVEL"
"RAPHAEL SELES DE AQUINO"	"NÃO DIVULGÁVEL"
"NIVALDO SANTOS"	"NÃO DIVULGÁVEL"
"FABIANA SANDOVAL"	"NÃO DIVULGÁVEL"
"ADENILSON VICENTE"	"ANALFABETO"
"MARCOS ANTONIO MONTEIRO"	"ANALFABETO"
"FRANCIS MARA DE OLIVEIRA DA SILVA"	"ANALFABETO"
"HELAINE CRISTINA BACAN RAMOS"	"ANALFABETO"
"BEATRIZ PISTELLI"	"ANALFABETO"
"MARINA CRISTINA ROBERTO"	"ANALFABETO"
"DAMARIS FERNANDA RODRIGUES"	"ANALFABETO"
"RODRIGO VENTALI CANATTO"	"ANALFABETO"
"PAULO CESAR MORELLI SALOTTI"	"ANALFABETO"
"MARCIA CARDOSO"	"ANALFABETO"
"MATHEUS OSWALDO BARBOSA"	"ANALFABETO"
"VALDECIR GABRIEL"	"ANALFABETO"
"AMELIA FERNANDA VIANA DE MORAES"	"ANALFABETO"
"FLAVIO ASTOLFI CAETANO NICO"	"ANALFABETO"
"MARTA GONÇALVES"	"ANALFABETO"
"LEANDRO JOSÉ DA SILVA"	"ANALFABETO"
"RILDO APARECIDO DIAS"	"ANALFABETO"
"PAULO ROBERTO BARATELLI"	"ANALFABETO"
"LAERCIO RAYMUNDO DOS SANTOS"	"ANALFABETO"
"LUCAS GABRIEL LEITE"	"ANALFABETO"
"JOSE HENRIQUE GENARI"	"ANALFABETO"
"LEANDRO BARBOZA DA SILVA"	"ANALFABETO"
"FRANCISCO AFONSO GONGORA"	"ANALFABETO"
"LUIZ MORATO MENDES"	"ANALFABETO"
"RAFAELA ROGÉRIO PIO COLOMBINI"	"ANALFABETO"
"MARCELO GALANTE LOPES DA CUNHA"	"ANALFABETO"
"ANTÔNIO BENEDITO FERREIRA"	"ANALFABETO"
"JOSÉ CLAUDIO MARTINS DOS REIS"	"ANALFABETO"
"CHRYSLER THIAGO DE AZEVEDO"	"ANALFABETO"
"TANIA MARA VENTURA"	"ANALFABETO"
"MARCO AURÉLIO DA SILVA"	"ANALFABETO"
"ANTONIO FRANCISCO SERAFIM"	"ANALFABETO"
"MARCOS ANTONIO RODRIGUES"	"ANALFABETO"
"LÍDIA JULIANA DE SOUZA"	"ANALFABETO"
"ELVIS ALEXANDRE RODRIGUES"	"ANALFABETO"
"THIAGO LOPES DAMACENO"	"ANALFABETO"
"CRIS MARSSELY CARVALHO SILVA SANTIAGO"	"ANALFABETO"
"FABIO JOSÉ ANDRADE DOS REIS"	"ANALFABETO"
"WANDERSON LUIS TELLES"	"ANALFABETO"
"EMERSON LUIS DA SILVA RODRIGUES"	"ANALFABETO"
"LAEDIR EUGENIO DELFINO"	"ANALFABETO"
"NÉLIO RICARDO DE OLIVEIRA"	"ANALFABETO"
"JULIO ANDERSON GRESPAN DIAS"	"ANALFABETO"
"LUAN CARLOS DE PAIVA NOGUEIRA"	"ANALFABETO"
"EVALDO PINHEIRO DOS SANTOS"	"ANALFABETO"
"CARINA MARQUES ALVES"	"ANALFABETO"
"ANAIDE ALVES BREGA"	"ANALFABETO"
"MARCIO LUIS SABAINI"	"ANALFABETO"
"JOSE ROBERTO SATI"	"ANALFABETO"
"STELA MARIA MENEGATO BACCI"	"ANALFABETO"
"MURILO ANTONIALLI GIORDAN"	"ANALFABETO"
"NADIA MARA GOMES ROSSETTO"	"ANALFABETO"
"CRISTIANO HENRIQUE MORENO BENTO"	"ANALFABETO"
"ADRIANA DONIZETTI DOS SANTOS FANTIM"	"ANALFABETO"
"DANIEL ABRAÃO SOARES MECHILÃO"	"ANALFABETO"
"MARLENE REZENDE DE SOUSA"	"ANALFABETO"
"SONIA REGINA PASSOS RIBEIRO"	"ANALFABETO"
"LUCIA REGINA PAULO RAMOS"	"ANALFABETO"
"JULIO CESAR AMANCIO DA SILVA"	"ANALFABETO"
"BRUNA LETICIA BERNARDO MARINGOLO"	"ANALFABETO"
"ROSANA LÚCIA DE PAULA STRAZZA"	"ANALFABETO"
"JOSELAINE DIAS MACHADO"	"ANALFABETO"
"LEANDRO CORNETA DA SILVA"	"ANALFABETO"
"VALTER TORRES RIBEIRO"	"ANALFABETO"
"CARLOS AUGUSTO DA COSTA PIRES TESCH"	"ANALFABETO"
"MARCELO DE ARAUJO PEREIRA"	"ANALFABETO"
"MARIA FERNANDA DA SILVA BUZATTO"	"ANALFABETO"
"OSCAR BAGNATORI JUNIOR"	"ANALFABETO"
"EVAIR SERRACINI DA COSTA"	"ANALFABETO"
"LUCIA HELENA BARBOSA PANSANI"	"ANALFABETO"
"JOSÉ AUGUSTO SAVEGNAGO"	"ANALFABETO"
"JOSE RODRIGUES CARVALHEIRO NETO"	"ANALFABETO"
"LEDA BELITARDO DE OLIVEIRA"	"ANALFABETO"
"REINALDO VENTAVOLI"	"ANALFABETO"
"FABIO SANDOVAL"	"ANALFABETO"
"IVONE PEDROSO DE MORAES ASSALIN"	"ANALFABETO"
"JOSE GERALDO COLOMBINI"	"ANALFABETO"
"DAIANA ROBERTA DOS SANTOS PIMENTA"	"ANALFABETO"
"SERGIO LUIZ DE OLIVEIRA"	"ANALFABETO"
"RENATO BARALDI ROMANO"	"ANALFABETO"
"MARCUS VINICIUS PARENTE QUERIDO AZEVEDO"	"ANALFABETO"
"ANDREA MARIA VIANA"	"ANALFABETO"
"ANTÔNIO JOSÉ DA SILVA LISBÔA"	"ANALFABETO"
"VALÉRIA DA SILVA LOPES"	"ANALFABETO"
"ACACIO SERGIO RIBEIRO SILVA"	"ANALFABETO"
"LUZ MARINA DE OLIVEIRA COSTA DE ANDRADE"	"ANALFABETO"
"JESSICA QUALIA DOS SANTOS OLIVEIRA ROMUALDO"	"ANALFABETO"
"ANTONIO CARLOS AMADEU"	"ANALFABETO"
"CARLOS ALBERTO SANTA ROSA FILHO"	"ANALFABETO"
"JOSE ARAUJO FILHO"	"ANALFABETO"
"JULIANA FERREIRA MAGNABOSCO"	"ANALFABETO"
"BEATRIZ HELENA ROSA"	"ANALFABETO"
"SILVIA HELENA FRANCISCO FREITAS"	"ANALFABETO"
"CARLOS ANDRÉ CASALLI"	"ANALFABETO"
"ALBERTO ZOGBI FILHO"	"ANALFABETO"
"SILVIA MARIA PALHARES MUSSI"	"ANALFABETO"
"ANTONIO DONIZETE MARCELINO"	"ANALFABETO"
"CARLA ROBERTA NOGUEIRA"	"ANALFABETO"
"ELIANE CRISTINA CASTELANI DA SILVA"	"ANALFABETO"
"NILSON DAS NEVES RODRIGUES JUNIOR"	"ANALFABETO"
"LUIZ GUSTAVO RONCHI DOS SANTOS"	"ANALFABETO"
"LUCIANO APARECIDO CANDIDO"	"ANALFABETO"
"ANTONIO CARLOS DE OLIVEIRA"	"ANALFABETO"
"ADILSON DE CAMPOS SALES"	"ANALFABETO"
"LUCAS SILVA DE FREITAS"	"ANALFABETO"
"RONALDO ADRIANO COELHO DE BRITTO"	"ANALFABETO"
"FLAVIO BALBINO"	"ANALFABETO"
"ALTOMIR BERNARDO DA SILVA"	"ANALFABETO"
"DAIANA MARA BAPTISTA"	"ANALFABETO"
"DEISE GILABERTI SANTIAGO SANTOS"	"ANALFABETO"
"GUSTAVO MAXIMIANO RODRIGUES DE OLIVEIRA"	"ANALFABETO"
"ANTONIO EDUARDO MARÇON NOGUEIRA"	"ANALFABETO"
"JOSÉ ANDERSON PEREIRA DOS SANTOS"	"ANALFABETO"
"GABRIELA CASTILHO GONÇALVES DE OLIVEIRA"	"ANALFABETO"
"WILLIAN ROMEIRO CALIXTO"	"ANALFABETO"
"EURICO SASSI FILHO"	"ANALFABETO"
"PAULINO TREVISAN"	"ANALFABETO"
"KARINA APARECIDA DE SOUSA SILVA TODERO"	"ANALFABETO"
"ROQUE CIACO NETO"	"ANALFABETO"
"RAPHAEL SELES DE AQUINO"	"ANALFABETO"
"NIVALDO SANTOS"	"ANALFABETO"
"FABIANA SANDOVAL"	"ANALFABETO"
"ADENILSON VICENTE"	"LÊ E ESCREVE"
"MARCOS ANTONIO MONTEIRO"	"LÊ E ESCREVE"
"FRANCIS MARA DE OLIVEIRA DA SILVA"	"LÊ E ESCREVE"
"HELAINE CRISTINA BACAN RAMOS"	"LÊ E ESCREVE"
"BEATRIZ PISTELLI"	"LÊ E ESCREVE"
"MARINA CRISTINA ROBERTO"	"LÊ E ESCREVE"
"DAMARIS FERNANDA RODRIGUES"	"LÊ E ESCREVE"
"RODRIGO VENTALI CANATTO"	"LÊ E ESCREVE"
"PAULO CESAR MORELLI SALOTTI"	"LÊ E ESCREVE"
"MARCIA CARDOSO"	"LÊ E ESCREVE"
"MATHEUS OSWALDO BARBOSA"	"LÊ E ESCREVE"
"VALDECIR GABRIEL"	"LÊ E ESCREVE"
"AMELIA FERNANDA VIANA DE MORAES"	"LÊ E ESCREVE"
"FLAVIO ASTOLFI CAETANO NICO"	"LÊ E ESCREVE"
"MARTA GONÇALVES"	"LÊ E ESCREVE"
"LEANDRO JOSÉ DA SILVA"	"LÊ E ESCREVE"
"RILDO APARECIDO DIAS"	"LÊ E ESCREVE"
"PAULO ROBERTO BARATELLI"	"LÊ E ESCREVE"
"LAERCIO RAYMUNDO DOS SANTOS"	"LÊ E ESCREVE"
"LUCAS GABRIEL LEITE"	"LÊ E ESCREVE"
"JOSE HENRIQUE GENARI"	"LÊ E ESCREVE"
"LEANDRO BARBOZA DA SILVA"	"LÊ E ESCREVE"
"FRANCISCO AFONSO GONGORA"	"LÊ E ESCREVE"
"LUIZ MORATO MENDES"	"LÊ E ESCREVE"
"RAFAELA ROGÉRIO PIO COLOMBINI"	"LÊ E ESCREVE"
"MARCELO GALANTE LOPES DA CUNHA"	"LÊ E ESCREVE"
"ANTÔNIO BENEDITO FERREIRA"	"LÊ E ESCREVE"
"JOSÉ CLAUDIO MARTINS DOS REIS"	"LÊ E ESCREVE"
"CHRYSLER THIAGO DE AZEVEDO"	"LÊ E ESCREVE"
"TANIA MARA VENTURA"	"LÊ E ESCREVE"
"MARCO AURÉLIO DA SILVA"	"LÊ E ESCREVE"
"ANTONIO FRANCISCO SERAFIM"	"LÊ E ESCREVE"
"MARCOS ANTONIO RODRIGUES"	"LÊ E ESCREVE"
"LÍDIA JULIANA DE SOUZA"	"LÊ E ESCREVE"
"ELVIS ALEXANDRE RODRIGUES"	"LÊ E ESCREVE"
"THIAGO LOPES DAMACENO"	"LÊ E ESCREVE"
"CRIS MARSSELY CARVALHO SILVA SANTIAGO"	"LÊ E ESCREVE"
"FABIO JOSÉ ANDRADE DOS REIS"	"LÊ E ESCREVE"
"WANDERSON LUIS TELLES"	"LÊ E ESCREVE"
"EMERSON LUIS DA SILVA RODRIGUES"	"LÊ E ESCREVE"
"LAEDIR EUGENIO DELFINO"	"LÊ E ESCREVE"
"NÉLIO RICARDO DE OLIVEIRA"	"LÊ E ESCREVE"
"JULIO ANDERSON GRESPAN DIAS"	"LÊ E ESCREVE"
"LUAN CARLOS DE PAIVA NOGUEIRA"	"LÊ E ESCREVE"
"EVALDO PINHEIRO DOS SANTOS"	"LÊ E ESCREVE"
"CARINA MARQUES ALVES"	"LÊ E ESCREVE"
"ANAIDE ALVES BREGA"	"LÊ E ESCREVE"
"MARCIO LUIS SABAINI"	"LÊ E ESCREVE"
"JOSE ROBERTO SATI"	"LÊ E ESCREVE"
"STELA MARIA MENEGATO BACCI"	"LÊ E ESCREVE"
"MURILO ANTONIALLI GIORDAN"	"LÊ E ESCREVE"
"NADIA MARA GOMES ROSSETTO"	"LÊ E ESCREVE"
"CRISTIANO HENRIQUE MORENO BENTO"	"LÊ E ESCREVE"
"ADRIANA DONIZETTI DOS SANTOS FANTIM"	"LÊ E ESCREVE"
"DANIEL ABRAÃO SOARES MECHILÃO"	"LÊ E ESCREVE"
"MARLENE REZENDE DE SOUSA"	"LÊ E ESCREVE"
"SONIA REGINA PASSOS RIBEIRO"	"LÊ E ESCREVE"
"LUCIA REGINA PAULO RAMOS"	"LÊ E ESCREVE"
"JULIO CESAR AMANCIO DA SILVA"	"LÊ E ESCREVE"
"BRUNA LETICIA BERNARDO MARINGOLO"	"LÊ E ESCREVE"
"ROSANA LÚCIA DE PAULA STRAZZA"	"LÊ E ESCREVE"
"JOSELAINE DIAS MACHADO"	"LÊ E ESCREVE"
"LEANDRO CORNETA DA SILVA"	"LÊ E ESCREVE"
"VALTER TORRES RIBEIRO"	"LÊ E ESCREVE"
"CARLOS AUGUSTO DA COSTA PIRES TESCH"	"LÊ E ESCREVE"
"MARCELO DE ARAUJO PEREIRA"	"LÊ E ESCREVE"
"MARIA FERNANDA DA SILVA BUZATTO"	"LÊ E ESCREVE"
"OSCAR BAGNATORI JUNIOR"	"LÊ E ESCREVE"
"EVAIR SERRACINI DA COSTA"	"LÊ E ESCREVE"
"LUCIA HELENA BARBOSA PANSANI"	"LÊ E ESCREVE"
"JOSÉ AUGUSTO SAVEGNAGO"	"LÊ E ESCREVE"
"JOSE RODRIGUES CARVALHEIRO NETO"	"LÊ E ESCREVE"
"LEDA BELITARDO DE OLIVEIRA"	"LÊ E ESCREVE"
"REINALDO VENTAVOLI"	"LÊ E ESCREVE"
"FABIO SANDOVAL"	"LÊ E ESCREVE"
"IVONE PEDROSO DE MORAES ASSALIN"	"LÊ E ESCREVE"
"JOSE GERALDO COLOMBINI"	"LÊ E ESCREVE"
"DAIANA ROBERTA DOS SANTOS PIMENTA"	"LÊ E ESCREVE"
"SERGIO LUIZ DE OLIVEIRA"	"LÊ E ESCREVE"
"RENATO BARALDI ROMANO"	"LÊ E ESCREVE"
"MARCUS VINICIUS PARENTE QUERIDO AZEVEDO"	"LÊ E ESCREVE"
"ANDREA MARIA VIANA"	"LÊ E ESCREVE"
"ANTÔNIO JOSÉ DA SILVA LISBÔA"	"LÊ E ESCREVE"
"VALÉRIA DA SILVA LOPES"	"LÊ E ESCREVE"
"ACACIO SERGIO RIBEIRO SILVA"	"LÊ E ESCREVE"
"LUZ MARINA DE OLIVEIRA COSTA DE ANDRADE"	"LÊ E ESCREVE"
"JESSICA QUALIA DOS SANTOS OLIVEIRA ROMUALDO"	"LÊ E ESCREVE"
"ANTONIO CARLOS AMADEU"	"LÊ E ESCREVE"
"CARLOS ALBERTO SANTA ROSA FILHO"	"LÊ E ESCREVE"
"JOSE ARAUJO FILHO"	"LÊ E ESCREVE"
"JULIANA FERREIRA MAGNABOSCO"	"LÊ E ESCREVE"
"BEATRIZ HELENA ROSA"	"LÊ E ESCREVE"
"SILVIA HELENA FRANCISCO FREITAS"	"LÊ E ESCREVE"
"CARLOS ANDRÉ CASALLI"	"LÊ E ESCREVE"
"ALBERTO ZOGBI FILHO"	"LÊ E ESCREVE"
"SILVIA MARIA PALHARES MUSSI"	"LÊ E ESCREVE"
"ANTONIO DONIZETE MARCELINO"	"LÊ E ESCREVE"
"CARLA ROBERTA NOGUEIRA"	"LÊ E ESCREVE"
"ELIANE CRISTINA CASTELANI DA SILVA"	"LÊ E ESCREVE"
"NILSON DAS NEVES RODRIGUES JUNIOR"	"LÊ E ESCREVE"
"LUIZ GUSTAVO RONCHI DOS SANTOS"	"LÊ E ESCREVE"
"LUCIANO APARECIDO CANDIDO"	"LÊ E ESCREVE"
"ANTONIO CARLOS DE OLIVEIRA"	"LÊ E ESCREVE"
"ADILSON DE CAMPOS SALES"	"LÊ E ESCREVE"
"LUCAS SILVA DE FREITAS"	"LÊ E ESCREVE"
"RONALDO ADRIANO COELHO DE BRITTO"	"LÊ E ESCREVE"
"FLAVIO BALBINO"	"LÊ E ESCREVE"
"ALTOMIR BERNARDO DA SILVA"	"LÊ E ESCREVE"
"DAIANA MARA BAPTISTA"	"LÊ E ESCREVE"
"DEISE GILABERTI SANTIAGO SANTOS"	"LÊ E ESCREVE"
"GUSTAVO MAXIMIANO RODRIGUES DE OLIVEIRA"	"LÊ E ESCREVE"
"ANTONIO EDUARDO MARÇON NOGUEIRA"	"LÊ E ESCREVE"
"JOSÉ ANDERSON PEREIRA DOS SANTOS"	"LÊ E ESCREVE"
"GABRIELA CASTILHO GONÇALVES DE OLIVEIRA"	"LÊ E ESCREVE"
"WILLIAN ROMEIRO CALIXTO"	"LÊ E ESCREVE"
"EURICO SASSI FILHO"	"LÊ E ESCREVE"
"PAULINO TREVISAN"	"LÊ E ESCREVE"
"KARINA APARECIDA DE SOUSA SILVA TODERO"	"LÊ E ESCREVE"
"ROQUE CIACO NETO"	"LÊ E ESCREVE"
"RAPHAEL SELES DE AQUINO"	"LÊ E ESCREVE"
"NIVALDO SANTOS"	"LÊ E ESCREVE"
"FABIANA SANDOVAL"	"LÊ E ESCREVE"
"ADENILSON VICENTE"	"ENSINO FUNDAMENTAL INCOMPLETO"
"MARCOS ANTONIO MONTEIRO"	"ENSINO FUNDAMENTAL INCOMPLETO"
"FRANCIS MARA DE OLIVEIRA DA SILVA"	"ENSINO FUNDAMENTAL INCOMPLETO"
"HELAINE CRISTINA BACAN RAMOS"	"ENSINO FUNDAMENTAL INCOMPLETO"
"BEATRIZ PISTELLI"	"ENSINO FUNDAMENTAL INCOMPLETO"
"MARINA CRISTINA ROBERTO"	"ENSINO FUNDAMENTAL INCOMPLETO"
"DAMARIS FERNANDA RODRIGUES"	"ENSINO FUNDAMENTAL INCOMPLETO"
"RODRIGO VENTALI CANATTO"	"ENSINO FUNDAMENTAL INCOMPLETO"
"PAULO CESAR MORELLI SALOTTI"	"ENSINO FUNDAMENTAL INCOMPLETO"
"MARCIA CARDOSO"	"ENSINO FUNDAMENTAL INCOMPLETO"
"MATHEUS OSWALDO BARBOSA"	"ENSINO FUNDAMENTAL INCOMPLETO"
"VALDECIR GABRIEL"	"ENSINO FUNDAMENTAL INCOMPLETO"
"AMELIA FERNANDA VIANA DE MORAES"	"ENSINO FUNDAMENTAL INCOMPLETO"
"FLAVIO ASTOLFI CAETANO NICO"	"ENSINO FUNDAMENTAL INCOMPLETO"
"MARTA GONÇALVES"	"ENSINO FUNDAMENTAL INCOMPLETO"
"LEANDRO JOSÉ DA SILVA"	"ENSINO FUNDAMENTAL INCOMPLETO"
"RILDO APARECIDO DIAS"	"ENSINO FUNDAMENTAL INCOMPLETO"
"PAULO ROBERTO BARATELLI"	"ENSINO FUNDAMENTAL INCOMPLETO"
"LAERCIO RAYMUNDO DOS SANTOS"	"ENSINO FUNDAMENTAL INCOMPLETO"
"LUCAS GABRIEL LEITE"	"ENSINO FUNDAMENTAL INCOMPLETO"
"JOSE HENRIQUE GENARI"	"ENSINO FUNDAMENTAL INCOMPLETO"
"LEANDRO BARBOZA DA SILVA"	"ENSINO FUNDAMENTAL INCOMPLETO"
"FRANCISCO AFONSO GONGORA"	"ENSINO FUNDAMENTAL INCOMPLETO"
"LUIZ MORATO MENDES"	"ENSINO FUNDAMENTAL INCOMPLETO"
"RAFAELA ROGÉRIO PIO COLOMBINI"	"ENSINO FUNDAMENTAL INCOMPLETO"
"MARCELO GALANTE LOPES DA CUNHA"	"ENSINO FUNDAMENTAL INCOMPLETO"
"ANTÔNIO BENEDITO FERREIRA"	"ENSINO FUNDAMENTAL INCOMPLETO"
"JOSÉ CLAUDIO MARTINS DOS REIS"	"ENSINO FUNDAMENTAL INCOMPLETO"
"CHRYSLER THIAGO DE AZEVEDO"	"ENSINO FUNDAMENTAL INCOMPLETO"
"TANIA MARA VENTURA"	"ENSINO FUNDAMENTAL INCOMPLETO"
"MARCO AURÉLIO DA SILVA"	"ENSINO FUNDAMENTAL INCOMPLETO"
"ANTONIO FRANCISCO SERAFIM"	"ENSINO FUNDAMENTAL INCOMPLETO"
"MARCOS ANTONIO RODRIGUES"	"ENSINO FUNDAMENTAL INCOMPLETO"
"LÍDIA JULIANA DE SOUZA"	"ENSINO FUNDAMENTAL INCOMPLETO"
"ELVIS ALEXANDRE RODRIGUES"	"ENSINO FUNDAMENTAL INCOMPLETO"
"THIAGO LOPES DAMACENO"	"ENSINO FUNDAMENTAL INCOMPLETO"
"CRIS MARSSELY CARVALHO SILVA SANTIAGO"	"ENSINO FUNDAMENTAL INCOMPLETO"
"FABIO JOSÉ ANDRADE DOS REIS"	"ENSINO FUNDAMENTAL INCOMPLETO"
"WANDERSON LUIS TELLES"	"ENSINO FUNDAMENTAL INCOMPLETO"
"EMERSON LUIS DA SILVA RODRIGUES"	"ENSINO FUNDAMENTAL INCOMPLETO"
"LAEDIR EUGENIO DELFINO"	"ENSINO FUNDAMENTAL INCOMPLETO"
"NÉLIO RICARDO DE OLIVEIRA"	"ENSINO FUNDAMENTAL INCOMPLETO"
"JULIO ANDERSON GRESPAN DIAS"	"ENSINO FUNDAMENTAL INCOMPLETO"
"LUAN CARLOS DE PAIVA NOGUEIRA"	"ENSINO FUNDAMENTAL INCOMPLETO"
"EVALDO PINHEIRO DOS SANTOS"	"ENSINO FUNDAMENTAL INCOMPLETO"
"CARINA MARQUES ALVES"	"ENSINO FUNDAMENTAL INCOMPLETO"
"ANAIDE ALVES BREGA"	"ENSINO FUNDAMENTAL INCOMPLETO"
"MARCIO LUIS SABAINI"	"ENSINO FUNDAMENTAL INCOMPLETO"
"JOSE ROBERTO SATI"	"ENSINO FUNDAMENTAL INCOMPLETO"
"STELA MARIA MENEGATO BACCI"	"ENSINO FUNDAMENTAL INCOMPLETO"
"MURILO ANTONIALLI GIORDAN"	"ENSINO FUNDAMENTAL INCOMPLETO"
"NADIA MARA GOMES ROSSETTO"	"ENSINO FUNDAMENTAL INCOMPLETO"
"CRISTIANO HENRIQUE MORENO BENTO"	"ENSINO FUNDAMENTAL INCOMPLETO"
"ADRIANA DONIZETTI DOS SANTOS FANTIM"	"ENSINO FUNDAMENTAL INCOMPLETO"
"DANIEL ABRAÃO SOARES MECHILÃO"	"ENSINO FUNDAMENTAL INCOMPLETO"
"MARLENE REZENDE DE SOUSA"	"ENSINO FUNDAMENTAL INCOMPLETO"
"SONIA REGINA PASSOS RIBEIRO"	"ENSINO FUNDAMENTAL INCOMPLETO"
"LUCIA REGINA PAULO RAMOS"	"ENSINO FUNDAMENTAL INCOMPLETO"
"JULIO CESAR AMANCIO DA SILVA"	"ENSINO FUNDAMENTAL INCOMPLETO"
"BRUNA LETICIA BERNARDO MARINGOLO"	"ENSINO FUNDAMENTAL INCOMPLETO"
"ROSANA LÚCIA DE PAULA STRAZZA"	"ENSINO FUNDAMENTAL INCOMPLETO"
"JOSELAINE DIAS MACHADO"	"ENSINO FUNDAMENTAL INCOMPLETO"
"LEANDRO CORNETA DA SILVA"	"ENSINO FUNDAMENTAL INCOMPLETO"
"VALTER TORRES RIBEIRO"	"ENSINO FUNDAMENTAL INCOMPLETO"
"CARLOS AUGUSTO DA COSTA PIRES TESCH"	"ENSINO FUNDAMENTAL INCOMPLETO"
"MARCELO DE ARAUJO PEREIRA"	"ENSINO FUNDAMENTAL INCOMPLETO"
"MARIA FERNANDA DA SILVA BUZATTO"	"ENSINO FUNDAMENTAL INCOMPLETO"
"OSCAR BAGNATORI JUNIOR"	"ENSINO FUNDAMENTAL INCOMPLETO"
"EVAIR SERRACINI DA COSTA"	"ENSINO FUNDAMENTAL INCOMPLETO"
"LUCIA HELENA BARBOSA PANSANI"	"ENSINO FUNDAMENTAL INCOMPLETO"
"JOSÉ AUGUSTO SAVEGNAGO"	"ENSINO FUNDAMENTAL INCOMPLETO"
"JOSE RODRIGUES CARVALHEIRO NETO"	"ENSINO FUNDAMENTAL INCOMPLETO"
"LEDA BELITARDO DE OLIVEIRA"	"ENSINO FUNDAMENTAL INCOMPLETO"
"REINALDO VENTAVOLI"	"ENSINO FUNDAMENTAL INCOMPLETO"
"FABIO SANDOVAL"	"ENSINO FUNDAMENTAL INCOMPLETO"
"IVONE PEDROSO DE MORAES ASSALIN"	"ENSINO FUNDAMENTAL INCOMPLETO"
"JOSE GERALDO COLOMBINI"	"ENSINO FUNDAMENTAL INCOMPLETO"
"DAIANA ROBERTA DOS SANTOS PIMENTA"	"ENSINO FUNDAMENTAL INCOMPLETO"
"SERGIO LUIZ DE OLIVEIRA"	"ENSINO FUNDAMENTAL INCOMPLETO"
"RENATO BARALDI ROMANO"	"ENSINO FUNDAMENTAL INCOMPLETO"
"MARCUS VINICIUS PARENTE QUERIDO AZEVEDO"	"ENSINO FUNDAMENTAL INCOMPLETO"
"ANDREA MARIA VIANA"	"ENSINO FUNDAMENTAL INCOMPLETO"
"ANTÔNIO JOSÉ DA SILVA LISBÔA"	"ENSINO FUNDAMENTAL INCOMPLETO"
"VALÉRIA DA SILVA LOPES"	"ENSINO FUNDAMENTAL INCOMPLETO"
"ACACIO SERGIO RIBEIRO SILVA"	"ENSINO FUNDAMENTAL INCOMPLETO"
"LUZ MARINA DE OLIVEIRA COSTA DE ANDRADE"	"ENSINO FUNDAMENTAL INCOMPLETO"
"JESSICA QUALIA DOS SANTOS OLIVEIRA ROMUALDO"	"ENSINO FUNDAMENTAL INCOMPLETO"
"ANTONIO CARLOS AMADEU"	"ENSINO FUNDAMENTAL INCOMPLETO"
"CARLOS ALBERTO SANTA ROSA FILHO"	"ENSINO FUNDAMENTAL INCOMPLETO"
"JOSE ARAUJO FILHO"	"ENSINO FUNDAMENTAL INCOMPLETO"
"JULIANA FERREIRA MAGNABOSCO"	"ENSINO FUNDAMENTAL INCOMPLETO"
"BEATRIZ HELENA ROSA"	"ENSINO FUNDAMENTAL INCOMPLETO"
"SILVIA HELENA FRANCISCO FREITAS"	"ENSINO FUNDAMENTAL INCOMPLETO"
"CARLOS ANDRÉ CASALLI"	"ENSINO FUNDAMENTAL INCOMPLETO"
"ALBERTO ZOGBI FILHO"	"ENSINO FUNDAMENTAL INCOMPLETO"
"SILVIA MARIA PALHARES MUSSI"	"ENSINO FUNDAMENTAL INCOMPLETO"
"ANTONIO DONIZETE MARCELINO"	"ENSINO FUNDAMENTAL INCOMPLETO"
"CARLA ROBERTA NOGUEIRA"	"ENSINO FUNDAMENTAL INCOMPLETO"
"ELIANE CRISTINA CASTELANI DA SILVA"	"ENSINO FUNDAMENTAL INCOMPLETO"
"NILSON DAS NEVES RODRIGUES JUNIOR"	"ENSINO FUNDAMENTAL INCOMPLETO"
"LUIZ GUSTAVO RONCHI DOS SANTOS"	"ENSINO FUNDAMENTAL INCOMPLETO"
"LUCIANO APARECIDO CANDIDO"	"ENSINO FUNDAMENTAL INCOMPLETO"
"ANTONIO CARLOS DE OLIVEIRA"	"ENSINO FUNDAMENTAL INCOMPLETO"
"ADILSON DE CAMPOS SALES"	"ENSINO FUNDAMENTAL INCOMPLETO"
"LUCAS SILVA DE FREITAS"	"ENSINO FUNDAMENTAL INCOMPLETO"
"RONALDO ADRIANO COELHO DE BRITTO"	"ENSINO FUNDAMENTAL INCOMPLETO"
"FLAVIO BALBINO"	"ENSINO FUNDAMENTAL INCOMPLETO"
"ALTOMIR BERNARDO DA SILVA"	"ENSINO FUNDAMENTAL INCOMPLETO"
"DAIANA MARA BAPTISTA"	"ENSINO FUNDAMENTAL INCOMPLETO"
"DEISE GILABERTI SANTIAGO SANTOS"	"ENSINO FUNDAMENTAL INCOMPLETO"
"GUSTAVO MAXIMIANO RODRIGUES DE OLIVEIRA"	"ENSINO FUNDAMENTAL INCOMPLETO"
"ANTONIO EDUARDO MARÇON NOGUEIRA"	"ENSINO FUNDAMENTAL INCOMPLETO"
"JOSÉ ANDERSON PEREIRA DOS SANTOS"	"ENSINO FUNDAMENTAL INCOMPLETO"
"GABRIELA CASTILHO GONÇALVES DE OLIVEIRA"	"ENSINO FUNDAMENTAL INCOMPLETO"
"WILLIAN ROMEIRO CALIXTO"	"ENSINO FUNDAMENTAL INCOMPLETO"
"EURICO SASSI FILHO"	"ENSINO FUNDAMENTAL INCOMPLETO"
"PAULINO TREVISAN"	"ENSINO FUNDAMENTAL INCOMPLETO"
"KARINA APARECIDA DE SOUSA SILVA TODERO"	"ENSINO FUNDAMENTAL INCOMPLETO"
"ROQUE CIACO NETO"	"ENSINO FUNDAMENTAL INCOMPLETO"
"RAPHAEL SELES DE AQUINO"	"ENSINO FUNDAMENTAL INCOMPLETO"
"NIVALDO SANTOS"	"ENSINO FUNDAMENTAL INCOMPLETO"
"FABIANA SANDOVAL"	"ENSINO FUNDAMENTAL INCOMPLETO"
"ADENILSON VICENTE"	"ENSINO FUNDAMENTAL COMPLETO"
"MARCOS ANTONIO MONTEIRO"	"ENSINO FUNDAMENTAL COMPLETO"
"FRANCIS MARA DE OLIVEIRA DA SILVA"	"ENSINO FUNDAMENTAL COMPLETO"
"HELAINE CRISTINA BACAN RAMOS"	"ENSINO FUNDAMENTAL COMPLETO"
"BEATRIZ PISTELLI"	"ENSINO FUNDAMENTAL COMPLETO"
"MARINA CRISTINA ROBERTO"	"ENSINO FUNDAMENTAL COMPLETO"
"DAMARIS FERNANDA RODRIGUES"	"ENSINO FUNDAMENTAL COMPLETO"
"RODRIGO VENTALI CANATTO"	"ENSINO FUNDAMENTAL COMPLETO"
"PAULO CESAR MORELLI SALOTTI"	"ENSINO FUNDAMENTAL COMPLETO"
"MARCIA CARDOSO"	"ENSINO FUNDAMENTAL COMPLETO"
"MATHEUS OSWALDO BARBOSA"	"ENSINO FUNDAMENTAL COMPLETO"
"VALDECIR GABRIEL"	"ENSINO FUNDAMENTAL COMPLETO"
"AMELIA FERNANDA VIANA DE MORAES"	"ENSINO FUNDAMENTAL COMPLETO"
"FLAVIO ASTOLFI CAETANO NICO"	"ENSINO FUNDAMENTAL COMPLETO"
"MARTA GONÇALVES"	"ENSINO FUNDAMENTAL COMPLETO"
"LEANDRO JOSÉ DA SILVA"	"ENSINO FUNDAMENTAL COMPLETO"
"RILDO APARECIDO DIAS"	"ENSINO FUNDAMENTAL COMPLETO"
"PAULO ROBERTO BARATELLI"	"ENSINO FUNDAMENTAL COMPLETO"
"LAERCIO RAYMUNDO DOS SANTOS"	"ENSINO FUNDAMENTAL COMPLETO"
"LUCAS GABRIEL LEITE"	"ENSINO FUNDAMENTAL COMPLETO"
"JOSE HENRIQUE GENARI"	"ENSINO FUNDAMENTAL COMPLETO"
"LEANDRO BARBOZA DA SILVA"	"ENSINO FUNDAMENTAL COMPLETO"
"FRANCISCO AFONSO GONGORA"	"ENSINO FUNDAMENTAL COMPLETO"
"LUIZ MORATO MENDES"	"ENSINO FUNDAMENTAL COMPLETO"
"RAFAELA ROGÉRIO PIO COLOMBINI"	"ENSINO FUNDAMENTAL COMPLETO"
"MARCELO GALANTE LOPES DA CUNHA"	"ENSINO FUNDAMENTAL COMPLETO"
"ANTÔNIO BENEDITO FERREIRA"	"ENSINO FUNDAMENTAL COMPLETO"
"JOSÉ CLAUDIO MARTINS DOS REIS"	"ENSINO FUNDAMENTAL COMPLETO"
"CHRYSLER THIAGO DE AZEVEDO"	"ENSINO FUNDAMENTAL COMPLETO"
"TANIA MARA VENTURA"	"ENSINO FUNDAMENTAL COMPLETO"
"MARCO AURÉLIO DA SILVA"	"ENSINO FUNDAMENTAL COMPLETO"
"ANTONIO FRANCISCO SERAFIM"	"ENSINO FUNDAMENTAL COMPLETO"
"MARCOS ANTONIO RODRIGUES"	"ENSINO FUNDAMENTAL COMPLETO"
"LÍDIA JULIANA DE SOUZA"	"ENSINO FUNDAMENTAL COMPLETO"
"ELVIS ALEXANDRE RODRIGUES"	"ENSINO FUNDAMENTAL COMPLETO"
"THIAGO LOPES DAMACENO"	"ENSINO FUNDAMENTAL COMPLETO"
"CRIS MARSSELY CARVALHO SILVA SANTIAGO"	"ENSINO FUNDAMENTAL COMPLETO"
"FABIO JOSÉ ANDRADE DOS REIS"	"ENSINO FUNDAMENTAL COMPLETO"
"WANDERSON LUIS TELLES"	"ENSINO FUNDAMENTAL COMPLETO"
"EMERSON LUIS DA SILVA RODRIGUES"	"ENSINO FUNDAMENTAL COMPLETO"
"LAEDIR EUGENIO DELFINO"	"ENSINO FUNDAMENTAL COMPLETO"
"NÉLIO RICARDO DE OLIVEIRA"	"ENSINO FUNDAMENTAL COMPLETO"
"JULIO ANDERSON GRESPAN DIAS"	"ENSINO FUNDAMENTAL COMPLETO"
"LUAN CARLOS DE PAIVA NOGUEIRA"	"ENSINO FUNDAMENTAL COMPLETO"
"EVALDO PINHEIRO DOS SANTOS"	"ENSINO FUNDAMENTAL COMPLETO"
"CARINA MARQUES ALVES"	"ENSINO FUNDAMENTAL COMPLETO"
"ANAIDE ALVES BREGA"	"ENSINO FUNDAMENTAL COMPLETO"
"MARCIO LUIS SABAINI"	"ENSINO FUNDAMENTAL COMPLETO"
"JOSE ROBERTO SATI"	"ENSINO FUNDAMENTAL COMPLETO"
"STELA MARIA MENEGATO BACCI"	"ENSINO FUNDAMENTAL COMPLETO"
"MURILO ANTONIALLI GIORDAN"	"ENSINO FUNDAMENTAL COMPLETO"
"NADIA MARA GOMES ROSSETTO"	"ENSINO FUNDAMENTAL COMPLETO"
"CRISTIANO HENRIQUE MORENO BENTO"	"ENSINO FUNDAMENTAL COMPLETO"
"ADRIANA DONIZETTI DOS SANTOS FANTIM"	"ENSINO FUNDAMENTAL COMPLETO"
"DANIEL ABRAÃO SOARES MECHILÃO"	"ENSINO FUNDAMENTAL COMPLETO"
"MARLENE REZENDE DE SOUSA"	"ENSINO FUNDAMENTAL COMPLETO"
"SONIA REGINA PASSOS RIBEIRO"	"ENSINO FUNDAMENTAL COMPLETO"
"LUCIA REGINA PAULO RAMOS"	"ENSINO FUNDAMENTAL COMPLETO"
"JULIO CESAR AMANCIO DA SILVA"	"ENSINO FUNDAMENTAL COMPLETO"
"BRUNA LETICIA BERNARDO MARINGOLO"	"ENSINO FUNDAMENTAL COMPLETO"
"ROSANA LÚCIA DE PAULA STRAZZA"	"ENSINO FUNDAMENTAL COMPLETO"
"JOSELAINE DIAS MACHADO"	"ENSINO FUNDAMENTAL COMPLETO"
"LEANDRO CORNETA DA SILVA"	"ENSINO FUNDAMENTAL COMPLETO"
"VALTER TORRES RIBEIRO"	"ENSINO FUNDAMENTAL COMPLETO"
"CARLOS AUGUSTO DA COSTA PIRES TESCH"	"ENSINO FUNDAMENTAL COMPLETO"
"MARCELO DE ARAUJO PEREIRA"	"ENSINO FUNDAMENTAL COMPLETO"
"MARIA FERNANDA DA SILVA BUZATTO"	"ENSINO FUNDAMENTAL COMPLETO"
"OSCAR BAGNATORI JUNIOR"	"ENSINO FUNDAMENTAL COMPLETO"
"EVAIR SERRACINI DA COSTA"	"ENSINO FUNDAMENTAL COMPLETO"
"LUCIA HELENA BARBOSA PANSANI"	"ENSINO FUNDAMENTAL COMPLETO"
"JOSÉ AUGUSTO SAVEGNAGO"	"ENSINO FUNDAMENTAL COMPLETO"
"JOSE RODRIGUES CARVALHEIRO NETO"	"ENSINO FUNDAMENTAL COMPLETO"
"LEDA BELITARDO DE OLIVEIRA"	"ENSINO FUNDAMENTAL COMPLETO"
"REINALDO VENTAVOLI"	"ENSINO FUNDAMENTAL COMPLETO"
"FABIO SANDOVAL"	"ENSINO FUNDAMENTAL COMPLETO"
"IVONE PEDROSO DE MORAES ASSALIN"	"ENSINO FUNDAMENTAL COMPLETO"
"JOSE GERALDO COLOMBINI"	"ENSINO FUNDAMENTAL COMPLETO"
"DAIANA ROBERTA DOS SANTOS PIMENTA"	"ENSINO FUNDAMENTAL COMPLETO"
"SERGIO LUIZ DE OLIVEIRA"	"ENSINO FUNDAMENTAL COMPLETO"
"RENATO BARALDI ROMANO"	"ENSINO FUNDAMENTAL COMPLETO"
"MARCUS VINICIUS PARENTE QUERIDO AZEVEDO"	"ENSINO FUNDAMENTAL COMPLETO"
"ANDREA MARIA VIANA"	"ENSINO FUNDAMENTAL COMPLETO"
"ANTÔNIO JOSÉ DA SILVA LISBÔA"	"ENSINO FUNDAMENTAL COMPLETO"
"VALÉRIA DA SILVA LOPES"	"ENSINO FUNDAMENTAL COMPLETO"
"ACACIO SERGIO RIBEIRO SILVA"	"ENSINO FUNDAMENTAL COMPLETO"
"LUZ MARINA DE OLIVEIRA COSTA DE ANDRADE"	"ENSINO FUNDAMENTAL COMPLETO"
"JESSICA QUALIA DOS SANTOS OLIVEIRA ROMUALDO"	"ENSINO FUNDAMENTAL COMPLETO"
"ANTONIO CARLOS AMADEU"	"ENSINO FUNDAMENTAL COMPLETO"
"CARLOS ALBERTO SANTA ROSA FILHO"	"ENSINO FUNDAMENTAL COMPLETO"
"JOSE ARAUJO FILHO"	"ENSINO FUNDAMENTAL COMPLETO"
"JULIANA FERREIRA MAGNABOSCO"	"ENSINO FUNDAMENTAL COMPLETO"
"BEATRIZ HELENA ROSA"	"ENSINO FUNDAMENTAL COMPLETO"
"SILVIA HELENA FRANCISCO FREITAS"	"ENSINO FUNDAMENTAL COMPLETO"
"CARLOS ANDRÉ CASALLI"	"ENSINO FUNDAMENTAL COMPLETO"
"ALBERTO ZOGBI FILHO"	"ENSINO FUNDAMENTAL COMPLETO"
"SILVIA MARIA PALHARES MUSSI"	"ENSINO FUNDAMENTAL COMPLETO"
"ANTONIO DONIZETE MARCELINO"	"ENSINO FUNDAMENTAL COMPLETO"
"CARLA ROBERTA NOGUEIRA"	"ENSINO FUNDAMENTAL COMPLETO"
"ELIANE CRISTINA CASTELANI DA SILVA"	"ENSINO FUNDAMENTAL COMPLETO"
"NILSON DAS NEVES RODRIGUES JUNIOR"	"ENSINO FUNDAMENTAL COMPLETO"
"LUIZ GUSTAVO RONCHI DOS SANTOS"	"ENSINO FUNDAMENTAL COMPLETO"
"LUCIANO APARECIDO CANDIDO"	"ENSINO FUNDAMENTAL COMPLETO"
"ANTONIO CARLOS DE OLIVEIRA"	"ENSINO FUNDAMENTAL COMPLETO"
"ADILSON DE CAMPOS SALES"	"ENSINO FUNDAMENTAL COMPLETO"
"LUCAS SILVA DE FREITAS"	"ENSINO FUNDAMENTAL COMPLETO"
"RONALDO ADRIANO COELHO DE BRITTO"	"ENSINO FUNDAMENTAL COMPLETO"
"FLAVIO BALBINO"	"ENSINO FUNDAMENTAL COMPLETO"
"ALTOMIR BERNARDO DA SILVA"	"ENSINO FUNDAMENTAL COMPLETO"
"DAIANA MARA BAPTISTA"	"ENSINO FUNDAMENTAL COMPLETO"
"DEISE GILABERTI SANTIAGO SANTOS"	"ENSINO FUNDAMENTAL COMPLETO"
"GUSTAVO MAXIMIANO RODRIGUES DE OLIVEIRA"	"ENSINO FUNDAMENTAL COMPLETO"
"ANTONIO EDUARDO MARÇON NOGUEIRA"	"ENSINO FUNDAMENTAL COMPLETO"
"JOSÉ ANDERSON PEREIRA DOS SANTOS"	"ENSINO FUNDAMENTAL COMPLETO"
"GABRIELA CASTILHO GONÇALVES DE OLIVEIRA"	"ENSINO FUNDAMENTAL COMPLETO"
"WILLIAN ROMEIRO CALIXTO"	"ENSINO FUNDAMENTAL COMPLETO"
"EURICO SASSI FILHO"	"ENSINO FUNDAMENTAL COMPLETO"
"PAULINO TREVISAN"	"ENSINO FUNDAMENTAL COMPLETO"
"KARINA APARECIDA DE SOUSA SILVA TODERO"	"ENSINO FUNDAMENTAL COMPLETO"
"ROQUE CIACO NETO"	"ENSINO FUNDAMENTAL COMPLETO"
"RAPHAEL SELES DE AQUINO"	"ENSINO FUNDAMENTAL COMPLETO"
"NIVALDO SANTOS"	"ENSINO FUNDAMENTAL COMPLETO"
"FABIANA SANDOVAL"	"ENSINO FUNDAMENTAL COMPLETO"
"ADENILSON VICENTE"	"ENSINO MÉDIO INCOMPLETO"
"MARCOS ANTONIO MONTEIRO"	"ENSINO MÉDIO INCOMPLETO"
"FRANCIS MARA DE OLIVEIRA DA SILVA"	"ENSINO MÉDIO INCOMPLETO"
"HELAINE CRISTINA BACAN RAMOS"	"ENSINO MÉDIO INCOMPLETO"
"BEATRIZ PISTELLI"	"ENSINO MÉDIO INCOMPLETO"
"MARINA CRISTINA ROBERTO"	"ENSINO MÉDIO INCOMPLETO"
"DAMARIS FERNANDA RODRIGUES"	"ENSINO MÉDIO INCOMPLETO"
"RODRIGO VENTALI CANATTO"	"ENSINO MÉDIO INCOMPLETO"
"PAULO CESAR MORELLI SALOTTI"	"ENSINO MÉDIO INCOMPLETO"
"MARCIA CARDOSO"	"ENSINO MÉDIO INCOMPLETO"
"MATHEUS OSWALDO BARBOSA"	"ENSINO MÉDIO INCOMPLETO"
"VALDECIR GABRIEL"	"ENSINO MÉDIO INCOMPLETO"
"AMELIA FERNANDA VIANA DE MORAES"	"ENSINO MÉDIO INCOMPLETO"
"FLAVIO ASTOLFI CAETANO NICO"	"ENSINO MÉDIO INCOMPLETO"
"MARTA GONÇALVES"	"ENSINO MÉDIO INCOMPLETO"
"LEANDRO JOSÉ DA SILVA"	"ENSINO MÉDIO INCOMPLETO"
"RILDO APARECIDO DIAS"	"ENSINO MÉDIO INCOMPLETO"
"PAULO ROBERTO BARATELLI"	"ENSINO MÉDIO INCOMPLETO"
"LAERCIO RAYMUNDO DOS SANTOS"	"ENSINO MÉDIO INCOMPLETO"
"LUCAS GABRIEL LEITE"	"ENSINO MÉDIO INCOMPLETO"
"JOSE HENRIQUE GENARI"	"ENSINO MÉDIO INCOMPLETO"
"LEANDRO BARBOZA DA SILVA"	"ENSINO MÉDIO INCOMPLETO"
"FRANCISCO AFONSO GONGORA"	"ENSINO MÉDIO INCOMPLETO"
"LUIZ MORATO MENDES"	"ENSINO MÉDIO INCOMPLETO"
"RAFAELA ROGÉRIO PIO COLOMBINI"	"ENSINO MÉDIO INCOMPLETO"
"MARCELO GALANTE LOPES DA CUNHA"	"ENSINO MÉDIO INCOMPLETO"
"ANTÔNIO BENEDITO FERREIRA"	"ENSINO MÉDIO INCOMPLETO"
"JOSÉ CLAUDIO MARTINS DOS REIS"	"ENSINO MÉDIO INCOMPLETO"
"CHRYSLER THIAGO DE AZEVEDO"	"ENSINO MÉDIO INCOMPLETO"
"TANIA MARA VENTURA"	"ENSINO MÉDIO INCOMPLETO"
"MARCO AURÉLIO DA SILVA"	"ENSINO MÉDIO INCOMPLETO"
"ANTONIO FRANCISCO SERAFIM"	"ENSINO MÉDIO INCOMPLETO"
"MARCOS ANTONIO RODRIGUES"	"ENSINO MÉDIO INCOMPLETO"
"LÍDIA JULIANA DE SOUZA"	"ENSINO MÉDIO INCOMPLETO"
"ELVIS ALEXANDRE RODRIGUES"	"ENSINO MÉDIO INCOMPLETO"
"THIAGO LOPES DAMACENO"	"ENSINO MÉDIO INCOMPLETO"
"CRIS MARSSELY CARVALHO SILVA SANTIAGO"	"ENSINO MÉDIO INCOMPLETO"
"FABIO JOSÉ ANDRADE DOS REIS"	"ENSINO MÉDIO INCOMPLETO"
"WANDERSON LUIS TELLES"	"ENSINO MÉDIO INCOMPLETO"
"EMERSON LUIS DA SILVA RODRIGUES"	"ENSINO MÉDIO INCOMPLETO"
"LAEDIR EUGENIO DELFINO"	"ENSINO MÉDIO INCOMPLETO"
"NÉLIO RICARDO DE OLIVEIRA"	"ENSINO MÉDIO INCOMPLETO"
"JULIO ANDERSON GRESPAN DIAS"	"ENSINO MÉDIO INCOMPLETO"
"LUAN CARLOS DE PAIVA NOGUEIRA"	"ENSINO MÉDIO INCOMPLETO"
"EVALDO PINHEIRO DOS SANTOS"	"ENSINO MÉDIO INCOMPLETO"
"CARINA MARQUES ALVES"	"ENSINO MÉDIO INCOMPLETO"
"ANAIDE ALVES BREGA"	"ENSINO MÉDIO INCOMPLETO"
"MARCIO LUIS SABAINI"	"ENSINO MÉDIO INCOMPLETO"
"JOSE ROBERTO SATI"	"ENSINO MÉDIO INCOMPLETO"
"STELA MARIA MENEGATO BACCI"	"ENSINO MÉDIO INCOMPLETO"
"MURILO ANTONIALLI GIORDAN"	"ENSINO MÉDIO INCOMPLETO"
"NADIA MARA GOMES ROSSETTO"	"ENSINO MÉDIO INCOMPLETO"
"CRISTIANO HENRIQUE MORENO BENTO"	"ENSINO MÉDIO INCOMPLETO"
"ADRIANA DONIZETTI DOS SANTOS FANTIM"	"ENSINO MÉDIO INCOMPLETO"
"DANIEL ABRAÃO SOARES MECHILÃO"	"ENSINO MÉDIO INCOMPLETO"
"MARLENE REZENDE DE SOUSA"	"ENSINO MÉDIO INCOMPLETO"
"SONIA REGINA PASSOS RIBEIRO"	"ENSINO MÉDIO INCOMPLETO"
"LUCIA REGINA PAULO RAMOS"	"ENSINO MÉDIO INCOMPLETO"
"JULIO CESAR AMANCIO DA SILVA"	"ENSINO MÉDIO INCOMPLETO"
"BRUNA LETICIA BERNARDO MARINGOLO"	"ENSINO MÉDIO INCOMPLETO"
"ROSANA LÚCIA DE PAULA STRAZZA"	"ENSINO MÉDIO INCOMPLETO"
"JOSELAINE DIAS MACHADO"	"ENSINO MÉDIO INCOMPLETO"
"LEANDRO CORNETA DA SILVA"	"ENSINO MÉDIO INCOMPLETO"
"VALTER TORRES RIBEIRO"	"ENSINO MÉDIO INCOMPLETO"
"CARLOS AUGUSTO DA COSTA PIRES TESCH"	"ENSINO MÉDIO INCOMPLETO"
"MARCELO DE ARAUJO PEREIRA"	"ENSINO MÉDIO INCOMPLETO"
"MARIA FERNANDA DA SILVA BUZATTO"	"ENSINO MÉDIO INCOMPLETO"
"OSCAR BAGNATORI JUNIOR"	"ENSINO MÉDIO INCOMPLETO"
"EVAIR SERRACINI DA COSTA"	"ENSINO MÉDIO INCOMPLETO"
"LUCIA HELENA BARBOSA PANSANI"	"ENSINO MÉDIO INCOMPLETO"
"JOSÉ AUGUSTO SAVEGNAGO"	"ENSINO MÉDIO INCOMPLETO"
"JOSE RODRIGUES CARVALHEIRO NETO"	"ENSINO MÉDIO INCOMPLETO"
"LEDA BELITARDO DE OLIVEIRA"	"ENSINO MÉDIO INCOMPLETO"
"REINALDO VENTAVOLI"	"ENSINO MÉDIO INCOMPLETO"
"FABIO SANDOVAL"	"ENSINO MÉDIO INCOMPLETO"
"IVONE PEDROSO DE MORAES ASSALIN"	"ENSINO MÉDIO INCOMPLETO"
"JOSE GERALDO COLOMBINI"	"ENSINO MÉDIO INCOMPLETO"
"DAIANA ROBERTA DOS SANTOS PIMENTA"	"ENSINO MÉDIO INCOMPLETO"
"SERGIO LUIZ DE OLIVEIRA"	"ENSINO MÉDIO INCOMPLETO"
"RENATO BARALDI ROMANO"	"ENSINO MÉDIO INCOMPLETO"
"MARCUS VINICIUS PARENTE QUERIDO AZEVEDO"	"ENSINO MÉDIO INCOMPLETO"
"ANDREA MARIA VIANA"	"ENSINO MÉDIO INCOMPLETO"
"ANTÔNIO JOSÉ DA SILVA LISBÔA"	"ENSINO MÉDIO INCOMPLETO"
"VALÉRIA DA SILVA LOPES"	"ENSINO MÉDIO INCOMPLETO"
"ACACIO SERGIO RIBEIRO SILVA"	"ENSINO MÉDIO INCOMPLETO"
"LUZ MARINA DE OLIVEIRA COSTA DE ANDRADE"	"ENSINO MÉDIO INCOMPLETO"
"JESSICA QUALIA DOS SANTOS OLIVEIRA ROMUALDO"	"ENSINO MÉDIO INCOMPLETO"
"ANTONIO CARLOS AMADEU"	"ENSINO MÉDIO INCOMPLETO"
"CARLOS ALBERTO SANTA ROSA FILHO"	"ENSINO MÉDIO INCOMPLETO"
"JOSE ARAUJO FILHO"	"ENSINO MÉDIO INCOMPLETO"
"JULIANA FERREIRA MAGNABOSCO"	"ENSINO MÉDIO INCOMPLETO"
"BEATRIZ HELENA ROSA"	"ENSINO MÉDIO INCOMPLETO"
"SILVIA HELENA FRANCISCO FREITAS"	"ENSINO MÉDIO INCOMPLETO"
"CARLOS ANDRÉ CASALLI"	"ENSINO MÉDIO INCOMPLETO"
"ALBERTO ZOGBI FILHO"	"ENSINO MÉDIO INCOMPLETO"
"SILVIA MARIA PALHARES MUSSI"	"ENSINO MÉDIO INCOMPLETO"
"ANTONIO DONIZETE MARCELINO"	"ENSINO MÉDIO INCOMPLETO"
"CARLA ROBERTA NOGUEIRA"	"ENSINO MÉDIO INCOMPLETO"
"ELIANE CRISTINA CASTELANI DA SILVA"	"ENSINO MÉDIO INCOMPLETO"
"NILSON DAS NEVES RODRIGUES JUNIOR"	"ENSINO MÉDIO INCOMPLETO"
"LUIZ GUSTAVO RONCHI DOS SANTOS"	"ENSINO MÉDIO INCOMPLETO"
"LUCIANO APARECIDO CANDIDO"	"ENSINO MÉDIO INCOMPLETO"
"ANTONIO CARLOS DE OLIVEIRA"	"ENSINO MÉDIO INCOMPLETO"
"ADILSON DE CAMPOS SALES"	"ENSINO MÉDIO INCOMPLETO"
"LUCAS SILVA DE FREITAS"	"ENSINO MÉDIO INCOMPLETO"
"RONALDO ADRIANO COELHO DE BRITTO"	"ENSINO MÉDIO INCOMPLETO"
"FLAVIO BALBINO"	"ENSINO MÉDIO INCOMPLETO"
"ALTOMIR BERNARDO DA SILVA"	"ENSINO MÉDIO INCOMPLETO"
"DAIANA MARA BAPTISTA"	"ENSINO MÉDIO INCOMPLETO"
"DEISE GILABERTI SANTIAGO SANTOS"	"ENSINO MÉDIO INCOMPLETO"
"GUSTAVO MAXIMIANO RODRIGUES DE OLIVEIRA"	"ENSINO MÉDIO INCOMPLETO"
"ANTONIO EDUARDO MARÇON NOGUEIRA"	"ENSINO MÉDIO INCOMPLETO"
"JOSÉ ANDERSON PEREIRA DOS SANTOS"	"ENSINO MÉDIO INCOMPLETO"
"GABRIELA CASTILHO GONÇALVES DE OLIVEIRA"	"ENSINO MÉDIO INCOMPLETO"
"WILLIAN ROMEIRO CALIXTO"	"ENSINO MÉDIO INCOMPLETO"
"EURICO SASSI FILHO"	"ENSINO MÉDIO INCOMPLETO"
"PAULINO TREVISAN"	"ENSINO MÉDIO INCOMPLETO"
"KARINA APARECIDA DE SOUSA SILVA TODERO"	"ENSINO MÉDIO INCOMPLETO"
"ROQUE CIACO NETO"	"ENSINO MÉDIO INCOMPLETO"
"RAPHAEL SELES DE AQUINO"	"ENSINO MÉDIO INCOMPLETO"
"NIVALDO SANTOS"	"ENSINO MÉDIO INCOMPLETO"
"FABIANA SANDOVAL"	"ENSINO MÉDIO INCOMPLETO"
"ADENILSON VICENTE"	"ENSINO MÉDIO COMPLETO"
"MARCOS ANTONIO MONTEIRO"	"ENSINO MÉDIO COMPLETO"
"FRANCIS MARA DE OLIVEIRA DA SILVA"	"ENSINO MÉDIO COMPLETO"
"HELAINE CRISTINA BACAN RAMOS"	"ENSINO MÉDIO COMPLETO"
"BEATRIZ PISTELLI"	"ENSINO MÉDIO COMPLETO"
"MARINA CRISTINA ROBERTO"	"ENSINO MÉDIO COMPLETO"
"DAMARIS FERNANDA RODRIGUES"	"ENSINO MÉDIO COMPLETO"
"RODRIGO VENTALI CANATTO"	"ENSINO MÉDIO COMPLETO"
"PAULO CESAR MORELLI SALOTTI"	"ENSINO MÉDIO COMPLETO"
"MARCIA CARDOSO"	"ENSINO MÉDIO COMPLETO"
"MATHEUS OSWALDO BARBOSA"	"ENSINO MÉDIO COMPLETO"
"VALDECIR GABRIEL"	"ENSINO MÉDIO COMPLETO"
"AMELIA FERNANDA VIANA DE MORAES"	"ENSINO MÉDIO COMPLETO"
"FLAVIO ASTOLFI CAETANO NICO"	"ENSINO MÉDIO COMPLETO"
"MARTA GONÇALVES"	"ENSINO MÉDIO COMPLETO"
"LEANDRO JOSÉ DA SILVA"	"ENSINO MÉDIO COMPLETO"
"RILDO APARECIDO DIAS"	"ENSINO MÉDIO COMPLETO"
"PAULO ROBERTO BARATELLI"	"ENSINO MÉDIO COMPLETO"
"LAERCIO RAYMUNDO DOS SANTOS"	"ENSINO MÉDIO COMPLETO"
"LUCAS GABRIEL LEITE"	"ENSINO MÉDIO COMPLETO"
"JOSE HENRIQUE GENARI"	"ENSINO MÉDIO COMPLETO"
"LEANDRO BARBOZA DA SILVA"	"ENSINO MÉDIO COMPLETO"
"FRANCISCO AFONSO GONGORA"	"ENSINO MÉDIO COMPLETO"
"LUIZ MORATO MENDES"	"ENSINO MÉDIO COMPLETO"
"RAFAELA ROGÉRIO PIO COLOMBINI"	"ENSINO MÉDIO COMPLETO"
"MARCELO GALANTE LOPES DA CUNHA"	"ENSINO MÉDIO COMPLETO"
"ANTÔNIO BENEDITO FERREIRA"	"ENSINO MÉDIO COMPLETO"
"JOSÉ CLAUDIO MARTINS DOS REIS"	"ENSINO MÉDIO COMPLETO"
"CHRYSLER THIAGO DE AZEVEDO"	"ENSINO MÉDIO COMPLETO"
"TANIA MARA VENTURA"	"ENSINO MÉDIO COMPLETO"
"MARCO AURÉLIO DA SILVA"	"ENSINO MÉDIO COMPLETO"
"ANTONIO FRANCISCO SERAFIM"	"ENSINO MÉDIO COMPLETO"
"MARCOS ANTONIO RODRIGUES"	"ENSINO MÉDIO COMPLETO"
"LÍDIA JULIANA DE SOUZA"	"ENSINO MÉDIO COMPLETO"
"ELVIS ALEXANDRE RODRIGUES"	"ENSINO MÉDIO COMPLETO"
"THIAGO LOPES DAMACENO"	"ENSINO MÉDIO COMPLETO"
"CRIS MARSSELY CARVALHO SILVA SANTIAGO"	"ENSINO MÉDIO COMPLETO"
"FABIO JOSÉ ANDRADE DOS REIS"	"ENSINO MÉDIO COMPLETO"
"WANDERSON LUIS TELLES"	"ENSINO MÉDIO COMPLETO"
"EMERSON LUIS DA SILVA RODRIGUES"	"ENSINO MÉDIO COMPLETO"
"LAEDIR EUGENIO DELFINO"	"ENSINO MÉDIO COMPLETO"
"NÉLIO RICARDO DE OLIVEIRA"	"ENSINO MÉDIO COMPLETO"
"JULIO ANDERSON GRESPAN DIAS"	"ENSINO MÉDIO COMPLETO"
"LUAN CARLOS DE PAIVA NOGUEIRA"	"ENSINO MÉDIO COMPLETO"
"EVALDO PINHEIRO DOS SANTOS"	"ENSINO MÉDIO COMPLETO"
"CARINA MARQUES ALVES"	"ENSINO MÉDIO COMPLETO"
"ANAIDE ALVES BREGA"	"ENSINO MÉDIO COMPLETO"
"MARCIO LUIS SABAINI"	"ENSINO MÉDIO COMPLETO"
"JOSE ROBERTO SATI"	"ENSINO MÉDIO COMPLETO"
"STELA MARIA MENEGATO BACCI"	"ENSINO MÉDIO COMPLETO"
"MURILO ANTONIALLI GIORDAN"	"ENSINO MÉDIO COMPLETO"
"NADIA MARA GOMES ROSSETTO"	"ENSINO MÉDIO COMPLETO"
"CRISTIANO HENRIQUE MORENO BENTO"	"ENSINO MÉDIO COMPLETO"
"ADRIANA DONIZETTI DOS SANTOS FANTIM"	"ENSINO MÉDIO COMPLETO"
"DANIEL ABRAÃO SOARES MECHILÃO"	"ENSINO MÉDIO COMPLETO"
"MARLENE REZENDE DE SOUSA"	"ENSINO MÉDIO COMPLETO"
"SONIA REGINA PASSOS RIBEIRO"	"ENSINO MÉDIO COMPLETO"
"LUCIA REGINA PAULO RAMOS"	"ENSINO MÉDIO COMPLETO"
"JULIO CESAR AMANCIO DA SILVA"	"ENSINO MÉDIO COMPLETO"
"BRUNA LETICIA BERNARDO MARINGOLO"	"ENSINO MÉDIO COMPLETO"
"ROSANA LÚCIA DE PAULA STRAZZA"	"ENSINO MÉDIO COMPLETO"
"JOSELAINE DIAS MACHADO"	"ENSINO MÉDIO COMPLETO"
"LEANDRO CORNETA DA SILVA"	"ENSINO MÉDIO COMPLETO"
"VALTER TORRES RIBEIRO"	"ENSINO MÉDIO COMPLETO"
"CARLOS AUGUSTO DA COSTA PIRES TESCH"	"ENSINO MÉDIO COMPLETO"
"MARCELO DE ARAUJO PEREIRA"	"ENSINO MÉDIO COMPLETO"
"MARIA FERNANDA DA SILVA BUZATTO"	"ENSINO MÉDIO COMPLETO"
"OSCAR BAGNATORI JUNIOR"	"ENSINO MÉDIO COMPLETO"
"EVAIR SERRACINI DA COSTA"	"ENSINO MÉDIO COMPLETO"
"LUCIA HELENA BARBOSA PANSANI"	"ENSINO MÉDIO COMPLETO"
"JOSÉ AUGUSTO SAVEGNAGO"	"ENSINO MÉDIO COMPLETO"
"JOSE RODRIGUES CARVALHEIRO NETO"	"ENSINO MÉDIO COMPLETO"
"LEDA BELITARDO DE OLIVEIRA"	"ENSINO MÉDIO COMPLETO"
"REINALDO VENTAVOLI"	"ENSINO MÉDIO COMPLETO"
"FABIO SANDOVAL"	"ENSINO MÉDIO COMPLETO"
"IVONE PEDROSO DE MORAES ASSALIN"	"ENSINO MÉDIO COMPLETO"
"JOSE GERALDO COLOMBINI"	"ENSINO MÉDIO COMPLETO"
"DAIANA ROBERTA DOS SANTOS PIMENTA"	"ENSINO MÉDIO COMPLETO"
"SERGIO LUIZ DE OLIVEIRA"	"ENSINO MÉDIO COMPLETO"
"RENATO BARALDI ROMANO"	"ENSINO MÉDIO COMPLETO"
"MARCUS VINICIUS PARENTE QUERIDO AZEVEDO"	"ENSINO MÉDIO COMPLETO"
"ANDREA MARIA VIANA"	"ENSINO MÉDIO COMPLETO"
"ANTÔNIO JOSÉ DA SILVA LISBÔA"	"ENSINO MÉDIO COMPLETO"
"VALÉRIA DA SILVA LOPES"	"ENSINO MÉDIO COMPLETO"
"ACACIO SERGIO RIBEIRO SILVA"	"ENSINO MÉDIO COMPLETO"
"LUZ MARINA DE OLIVEIRA COSTA DE ANDRADE"	"ENSINO MÉDIO COMPLETO"
"JESSICA QUALIA DOS SANTOS OLIVEIRA ROMUALDO"	"ENSINO MÉDIO COMPLETO"
"ANTONIO CARLOS AMADEU"	"ENSINO MÉDIO COMPLETO"
"CARLOS ALBERTO SANTA ROSA FILHO"	"ENSINO MÉDIO COMPLETO"
"JOSE ARAUJO FILHO"	"ENSINO MÉDIO COMPLETO"
"JULIANA FERREIRA MAGNABOSCO"	"ENSINO MÉDIO COMPLETO"
"BEATRIZ HELENA ROSA"	"ENSINO MÉDIO COMPLETO"
"SILVIA HELENA FRANCISCO FREITAS"	"ENSINO MÉDIO COMPLETO"
"CARLOS ANDRÉ CASALLI"	"ENSINO MÉDIO COMPLETO"
"ALBERTO ZOGBI FILHO"	"ENSINO MÉDIO COMPLETO"
"SILVIA MARIA PALHARES MUSSI"	"ENSINO MÉDIO COMPLETO"
"ANTONIO DONIZETE MARCELINO"	"ENSINO MÉDIO COMPLETO"
"CARLA ROBERTA NOGUEIRA"	"ENSINO MÉDIO COMPLETO"
"ELIANE CRISTINA CASTELANI DA SILVA"	"ENSINO MÉDIO COMPLETO"
"NILSON DAS NEVES RODRIGUES JUNIOR"	"ENSINO MÉDIO COMPLETO"
"LUIZ GUSTAVO RONCHI DOS SANTOS"	"ENSINO MÉDIO COMPLETO"
"LUCIANO APARECIDO CANDIDO"	"ENSINO MÉDIO COMPLETO"
"ANTONIO CARLOS DE OLIVEIRA"	"ENSINO MÉDIO COMPLETO"
"ADILSON DE CAMPOS SALES"	"ENSINO MÉDIO COMPLETO"
"LUCAS SILVA DE FREITAS"	"ENSINO MÉDIO COMPLETO"
"RONALDO ADRIANO COELHO DE BRITTO"	"ENSINO MÉDIO COMPLETO"
"FLAVIO BALBINO"	"ENSINO MÉDIO COMPLETO"
"ALTOMIR BERNARDO DA SILVA"	"ENSINO MÉDIO COMPLETO"
"DAIANA MARA BAPTISTA"	"ENSINO MÉDIO COMPLETO"
"DEISE GILABERTI SANTIAGO SANTOS"	"ENSINO MÉDIO COMPLETO"
"GUSTAVO MAXIMIANO RODRIGUES DE OLIVEIRA"	"ENSINO MÉDIO COMPLETO"
"ANTONIO EDUARDO MARÇON NOGUEIRA"	"ENSINO MÉDIO COMPLETO"
"JOSÉ ANDERSON PEREIRA DOS SANTOS"	"ENSINO MÉDIO COMPLETO"
"GABRIELA CASTILHO GONÇALVES DE OLIVEIRA"	"ENSINO MÉDIO COMPLETO"
"WILLIAN ROMEIRO CALIXTO"	"ENSINO MÉDIO COMPLETO"
"EURICO SASSI FILHO"	"ENSINO MÉDIO COMPLETO"
"PAULINO TREVISAN"	"ENSINO MÉDIO COMPLETO"
"KARINA APARECIDA DE SOUSA SILVA TODERO"	"ENSINO MÉDIO COMPLETO"
"ROQUE CIACO NETO"	"ENSINO MÉDIO COMPLETO"
"RAPHAEL SELES DE AQUINO"	"ENSINO MÉDIO COMPLETO"
"NIVALDO SANTOS"	"ENSINO MÉDIO COMPLETO"
"FABIANA SANDOVAL"	"ENSINO MÉDIO COMPLETO"
"ADENILSON VICENTE"	"SUPERIOR INCOMPLETO"
"MARCOS ANTONIO MONTEIRO"	"SUPERIOR INCOMPLETO"
"FRANCIS MARA DE OLIVEIRA DA SILVA"	"SUPERIOR INCOMPLETO"
"HELAINE CRISTINA BACAN RAMOS"	"SUPERIOR INCOMPLETO"
"BEATRIZ PISTELLI"	"SUPERIOR INCOMPLETO"
"MARINA CRISTINA ROBERTO"	"SUPERIOR INCOMPLETO"
"DAMARIS FERNANDA RODRIGUES"	"SUPERIOR INCOMPLETO"
"RODRIGO VENTALI CANATTO"	"SUPERIOR INCOMPLETO"
"PAULO CESAR MORELLI SALOTTI"	"SUPERIOR INCOMPLETO"
"MARCIA CARDOSO"	"SUPERIOR INCOMPLETO"
"MATHEUS OSWALDO BARBOSA"	"SUPERIOR INCOMPLETO"
"VALDECIR GABRIEL"	"SUPERIOR INCOMPLETO"
"AMELIA FERNANDA VIANA DE MORAES"	"SUPERIOR INCOMPLETO"
"FLAVIO ASTOLFI CAETANO NICO"	"SUPERIOR INCOMPLETO"
"MARTA GONÇALVES"	"SUPERIOR INCOMPLETO"
"LEANDRO JOSÉ DA SILVA"	"SUPERIOR INCOMPLETO"
"RILDO APARECIDO DIAS"	"SUPERIOR INCOMPLETO"
"PAULO ROBERTO BARATELLI"	"SUPERIOR INCOMPLETO"
"LAERCIO RAYMUNDO DOS SANTOS"	"SUPERIOR INCOMPLETO"
"LUCAS GABRIEL LEITE"	"SUPERIOR INCOMPLETO"
"JOSE HENRIQUE GENARI"	"SUPERIOR INCOMPLETO"
"LEANDRO BARBOZA DA SILVA"	"SUPERIOR INCOMPLETO"
"FRANCISCO AFONSO GONGORA"	"SUPERIOR INCOMPLETO"
"LUIZ MORATO MENDES"	"SUPERIOR INCOMPLETO"
"RAFAELA ROGÉRIO PIO COLOMBINI"	"SUPERIOR INCOMPLETO"
"MARCELO GALANTE LOPES DA CUNHA"	"SUPERIOR INCOMPLETO"
"ANTÔNIO BENEDITO FERREIRA"	"SUPERIOR INCOMPLETO"
"JOSÉ CLAUDIO MARTINS DOS REIS"	"SUPERIOR INCOMPLETO"
"CHRYSLER THIAGO DE AZEVEDO"	"SUPERIOR INCOMPLETO"
"TANIA MARA VENTURA"	"SUPERIOR INCOMPLETO"
"MARCO AURÉLIO DA SILVA"	"SUPERIOR INCOMPLETO"
"ANTONIO FRANCISCO SERAFIM"	"SUPERIOR INCOMPLETO"
"MARCOS ANTONIO RODRIGUES"	"SUPERIOR INCOMPLETO"
"LÍDIA JULIANA DE SOUZA"	"SUPERIOR INCOMPLETO"
"ELVIS ALEXANDRE RODRIGUES"	"SUPERIOR INCOMPLETO"
"THIAGO LOPES DAMACENO"	"SUPERIOR INCOMPLETO"
"CRIS MARSSELY CARVALHO SILVA SANTIAGO"	"SUPERIOR INCOMPLETO"
"FABIO JOSÉ ANDRADE DOS REIS"	"SUPERIOR INCOMPLETO"
"WANDERSON LUIS TELLES"	"SUPERIOR INCOMPLETO"
"EMERSON LUIS DA SILVA RODRIGUES"	"SUPERIOR INCOMPLETO"
"LAEDIR EUGENIO DELFINO"	"SUPERIOR INCOMPLETO"
"NÉLIO RICARDO DE OLIVEIRA"	"SUPERIOR INCOMPLETO"
"JULIO ANDERSON GRESPAN DIAS"	"SUPERIOR INCOMPLETO"
"LUAN CARLOS DE PAIVA NOGUEIRA"	"SUPERIOR INCOMPLETO"
"EVALDO PINHEIRO DOS SANTOS"	"SUPERIOR INCOMPLETO"
"CARINA MARQUES ALVES"	"SUPERIOR INCOMPLETO"
"ANAIDE ALVES BREGA"	"SUPERIOR INCOMPLETO"
"MARCIO LUIS SABAINI"	"SUPERIOR INCOMPLETO"
"JOSE ROBERTO SATI"	"SUPERIOR INCOMPLETO"
"STELA MARIA MENEGATO BACCI"	"SUPERIOR INCOMPLETO"
"MURILO ANTONIALLI GIORDAN"	"SUPERIOR INCOMPLETO"
"NADIA MARA GOMES ROSSETTO"	"SUPERIOR INCOMPLETO"
"CRISTIANO HENRIQUE MORENO BENTO"	"SUPERIOR INCOMPLETO"
"ADRIANA DONIZETTI DOS SANTOS FANTIM"	"SUPERIOR INCOMPLETO"
"DANIEL ABRAÃO SOARES MECHILÃO"	"SUPERIOR INCOMPLETO"
"MARLENE REZENDE DE SOUSA"	"SUPERIOR INCOMPLETO"
"SONIA REGINA PASSOS RIBEIRO"	"SUPERIOR INCOMPLETO"
"LUCIA REGINA PAULO RAMOS"	"SUPERIOR INCOMPLETO"
"JULIO CESAR AMANCIO DA SILVA"	"SUPERIOR INCOMPLETO"
"BRUNA LETICIA BERNARDO MARINGOLO"	"SUPERIOR INCOMPLETO"
"ROSANA LÚCIA DE PAULA STRAZZA"	"SUPERIOR INCOMPLETO"
"JOSELAINE DIAS MACHADO"	"SUPERIOR INCOMPLETO"
"LEANDRO CORNETA DA SILVA"	"SUPERIOR INCOMPLETO"
"VALTER TORRES RIBEIRO"	"SUPERIOR INCOMPLETO"
"CARLOS AUGUSTO DA COSTA PIRES TESCH"	"SUPERIOR INCOMPLETO"
"MARCELO DE ARAUJO PEREIRA"	"SUPERIOR INCOMPLETO"
"MARIA FERNANDA DA SILVA BUZATTO"	"SUPERIOR INCOMPLETO"
"OSCAR BAGNATORI JUNIOR"	"SUPERIOR INCOMPLETO"
"EVAIR SERRACINI DA COSTA"	"SUPERIOR INCOMPLETO"
"LUCIA HELENA BARBOSA PANSANI"	"SUPERIOR INCOMPLETO"
"JOSÉ AUGUSTO SAVEGNAGO"	"SUPERIOR INCOMPLETO"
"JOSE RODRIGUES CARVALHEIRO NETO"	"SUPERIOR INCOMPLETO"
"LEDA BELITARDO DE OLIVEIRA"	"SUPERIOR INCOMPLETO"
"REINALDO VENTAVOLI"	"SUPERIOR INCOMPLETO"
"FABIO SANDOVAL"	"SUPERIOR INCOMPLETO"
"IVONE PEDROSO DE MORAES ASSALIN"	"SUPERIOR INCOMPLETO"
"JOSE GERALDO COLOMBINI"	"SUPERIOR INCOMPLETO"
"DAIANA ROBERTA DOS SANTOS PIMENTA"	"SUPERIOR INCOMPLETO"
"SERGIO LUIZ DE OLIVEIRA"	"SUPERIOR INCOMPLETO"
"RENATO BARALDI ROMANO"	"SUPERIOR INCOMPLETO"
"MARCUS VINICIUS PARENTE QUERIDO AZEVEDO"	"SUPERIOR INCOMPLETO"
"ANDREA MARIA VIANA"	"SUPERIOR INCOMPLETO"
"ANTÔNIO JOSÉ DA SILVA LISBÔA"	"SUPERIOR INCOMPLETO"
"VALÉRIA DA SILVA LOPES"	"SUPERIOR INCOMPLETO"
"ACACIO SERGIO RIBEIRO SILVA"	"SUPERIOR INCOMPLETO"
"LUZ MARINA DE OLIVEIRA COSTA DE ANDRADE"	"SUPERIOR INCOMPLETO"
"JESSICA QUALIA DOS SANTOS OLIVEIRA ROMUALDO"	"SUPERIOR INCOMPLETO"
"ANTONIO CARLOS AMADEU"	"SUPERIOR INCOMPLETO"
"CARLOS ALBERTO SANTA ROSA FILHO"	"SUPERIOR INCOMPLETO"
"JOSE ARAUJO FILHO"	"SUPERIOR INCOMPLETO"
"JULIANA FERREIRA MAGNABOSCO"	"SUPERIOR INCOMPLETO"
"BEATRIZ HELENA ROSA"	"SUPERIOR INCOMPLETO"
"SILVIA HELENA FRANCISCO FREITAS"	"SUPERIOR INCOMPLETO"
"CARLOS ANDRÉ CASALLI"	"SUPERIOR INCOMPLETO"
"ALBERTO ZOGBI FILHO"	"SUPERIOR INCOMPLETO"
"SILVIA MARIA PALHARES MUSSI"	"SUPERIOR INCOMPLETO"
"ANTONIO DONIZETE MARCELINO"	"SUPERIOR INCOMPLETO"
"CARLA ROBERTA NOGUEIRA"	"SUPERIOR INCOMPLETO"
"ELIANE CRISTINA CASTELANI DA SILVA"	"SUPERIOR INCOMPLETO"
"NILSON DAS NEVES RODRIGUES JUNIOR"	"SUPERIOR INCOMPLETO"
"LUIZ GUSTAVO RONCHI DOS SANTOS"	"SUPERIOR INCOMPLETO"
"LUCIANO APARECIDO CANDIDO"	"SUPERIOR INCOMPLETO"
"ANTONIO CARLOS DE OLIVEIRA"	"SUPERIOR INCOMPLETO"
"ADILSON DE CAMPOS SALES"	"SUPERIOR INCOMPLETO"
"LUCAS SILVA DE FREITAS"	"SUPERIOR INCOMPLETO"
"RONALDO ADRIANO COELHO DE BRITTO"	"SUPERIOR INCOMPLETO"
"FLAVIO BALBINO"	"SUPERIOR INCOMPLETO"
"ALTOMIR BERNARDO DA SILVA"	"SUPERIOR INCOMPLETO"
"DAIANA MARA BAPTISTA"	"SUPERIOR INCOMPLETO"
"DEISE GILABERTI SANTIAGO SANTOS"	"SUPERIOR INCOMPLETO"
"GUSTAVO MAXIMIANO RODRIGUES DE OLIVEIRA"	"SUPERIOR INCOMPLETO"
"ANTONIO EDUARDO MARÇON NOGUEIRA"	"SUPERIOR INCOMPLETO"
"JOSÉ ANDERSON PEREIRA DOS SANTOS"	"SUPERIOR INCOMPLETO"
"GABRIELA CASTILHO GONÇALVES DE OLIVEIRA"	"SUPERIOR INCOMPLETO"
"WILLIAN ROMEIRO CALIXTO"	"SUPERIOR INCOMPLETO"
"EURICO SASSI FILHO"	"SUPERIOR INCOMPLETO"
"PAULINO TREVISAN"	"SUPERIOR INCOMPLETO"
"KARINA APARECIDA DE SOUSA SILVA TODERO"	"SUPERIOR INCOMPLETO"
"ROQUE CIACO NETO"	"SUPERIOR INCOMPLETO"
"RAPHAEL SELES DE AQUINO"	"SUPERIOR INCOMPLETO"
"NIVALDO SANTOS"	"SUPERIOR INCOMPLETO"
"FABIANA SANDOVAL"	"SUPERIOR INCOMPLETO"
"ADENILSON VICENTE"	"SUPERIOR COMPLETO"
"MARCOS ANTONIO MONTEIRO"	"SUPERIOR COMPLETO"
"FRANCIS MARA DE OLIVEIRA DA SILVA"	"SUPERIOR COMPLETO"
"HELAINE CRISTINA BACAN RAMOS"	"SUPERIOR COMPLETO"
"BEATRIZ PISTELLI"	"SUPERIOR COMPLETO"
"MARINA CRISTINA ROBERTO"	"SUPERIOR COMPLETO"
"DAMARIS FERNANDA RODRIGUES"	"SUPERIOR COMPLETO"
"RODRIGO VENTALI CANATTO"	"SUPERIOR COMPLETO"
"PAULO CESAR MORELLI SALOTTI"	"SUPERIOR COMPLETO"
"MARCIA CARDOSO"	"SUPERIOR COMPLETO"
"MATHEUS OSWALDO BARBOSA"	"SUPERIOR COMPLETO"
"VALDECIR GABRIEL"	"SUPERIOR COMPLETO"
"AMELIA FERNANDA VIANA DE MORAES"	"SUPERIOR COMPLETO"
"FLAVIO ASTOLFI CAETANO NICO"	"SUPERIOR COMPLETO"
"MARTA GONÇALVES"	"SUPERIOR COMPLETO"
"LEANDRO JOSÉ DA SILVA"	"SUPERIOR COMPLETO"
"RILDO APARECIDO DIAS"	"SUPERIOR COMPLETO"
"PAULO ROBERTO BARATELLI"	"SUPERIOR COMPLETO"
"LAERCIO RAYMUNDO DOS SANTOS"	"SUPERIOR COMPLETO"
"LUCAS GABRIEL LEITE"	"SUPERIOR COMPLETO"
"JOSE HENRIQUE GENARI"	"SUPERIOR COMPLETO"
"LEANDRO BARBOZA DA SILVA"	"SUPERIOR COMPLETO"
"FRANCISCO AFONSO GONGORA"	"SUPERIOR COMPLETO"
"LUIZ MORATO MENDES"	"SUPERIOR COMPLETO"
"RAFAELA ROGÉRIO PIO COLOMBINI"	"SUPERIOR COMPLETO"
"MARCELO GALANTE LOPES DA CUNHA"	"SUPERIOR COMPLETO"
"ANTÔNIO BENEDITO FERREIRA"	"SUPERIOR COMPLETO"
"JOSÉ CLAUDIO MARTINS DOS REIS"	"SUPERIOR COMPLETO"
"CHRYSLER THIAGO DE AZEVEDO"	"SUPERIOR COMPLETO"
"TANIA MARA VENTURA"	"SUPERIOR COMPLETO"
"MARCO AURÉLIO DA SILVA"	"SUPERIOR COMPLETO"
"ANTONIO FRANCISCO SERAFIM"	"SUPERIOR COMPLETO"
"MARCOS ANTONIO RODRIGUES"	"SUPERIOR COMPLETO"
"LÍDIA JULIANA DE SOUZA"	"SUPERIOR COMPLETO"
"ELVIS ALEXANDRE RODRIGUES"	"SUPERIOR COMPLETO"
"THIAGO LOPES DAMACENO"	"SUPERIOR COMPLETO"
"CRIS MARSSELY CARVALHO SILVA SANTIAGO"	"SUPERIOR COMPLETO"
"FABIO JOSÉ ANDRADE DOS REIS"	"SUPERIOR COMPLETO"
"WANDERSON LUIS TELLES"	"SUPERIOR COMPLETO"
"EMERSON LUIS DA SILVA RODRIGUES"	"SUPERIOR COMPLETO"
"LAEDIR EUGENIO DELFINO"	"SUPERIOR COMPLETO"
"NÉLIO RICARDO DE OLIVEIRA"	"SUPERIOR COMPLETO"
"JULIO ANDERSON GRESPAN DIAS"	"SUPERIOR COMPLETO"
"LUAN CARLOS DE PAIVA NOGUEIRA"	"SUPERIOR COMPLETO"
"EVALDO PINHEIRO DOS SANTOS"	"SUPERIOR COMPLETO"
"CARINA MARQUES ALVES"	"SUPERIOR COMPLETO"
"ANAIDE ALVES BREGA"	"SUPERIOR COMPLETO"
"MARCIO LUIS SABAINI"	"SUPERIOR COMPLETO"
"JOSE ROBERTO SATI"	"SUPERIOR COMPLETO"
"STELA MARIA MENEGATO BACCI"	"SUPERIOR COMPLETO"
"MURILO ANTONIALLI GIORDAN"	"SUPERIOR COMPLETO"
"NADIA MARA GOMES ROSSETTO"	"SUPERIOR COMPLETO"
"CRISTIANO HENRIQUE MORENO BENTO"	"SUPERIOR COMPLETO"
"ADRIANA DONIZETTI DOS SANTOS FANTIM"	"SUPERIOR COMPLETO"
"DANIEL ABRAÃO SOARES MECHILÃO"	"SUPERIOR COMPLETO"
"MARLENE REZENDE DE SOUSA"	"SUPERIOR COMPLETO"
"SONIA REGINA PASSOS RIBEIRO"	"SUPERIOR COMPLETO"
"LUCIA REGINA PAULO RAMOS"	"SUPERIOR COMPLETO"
"JULIO CESAR AMANCIO DA SILVA"	"SUPERIOR COMPLETO"
"BRUNA LETICIA BERNARDO MARINGOLO"	"SUPERIOR COMPLETO"
"ROSANA LÚCIA DE PAULA STRAZZA"	"SUPERIOR COMPLETO"
"JOSELAINE DIAS MACHADO"	"SUPERIOR COMPLETO"
"LEANDRO CORNETA DA SILVA"	"SUPERIOR COMPLETO"
"VALTER TORRES RIBEIRO"	"SUPERIOR COMPLETO"
"CARLOS AUGUSTO DA COSTA PIRES TESCH"	"SUPERIOR COMPLETO"
"MARCELO DE ARAUJO PEREIRA"	"SUPERIOR COMPLETO"
"MARIA FERNANDA DA SILVA BUZATTO"	"SUPERIOR COMPLETO"
"OSCAR BAGNATORI JUNIOR"	"SUPERIOR COMPLETO"
"EVAIR SERRACINI DA COSTA"	"SUPERIOR COMPLETO"
"LUCIA HELENA BARBOSA PANSANI"	"SUPERIOR COMPLETO"
"JOSÉ AUGUSTO SAVEGNAGO"	"SUPERIOR COMPLETO"
"JOSE RODRIGUES CARVALHEIRO NETO"	"SUPERIOR COMPLETO"
"LEDA BELITARDO DE OLIVEIRA"	"SUPERIOR COMPLETO"
"REINALDO VENTAVOLI"	"SUPERIOR COMPLETO"
"FABIO SANDOVAL"	"SUPERIOR COMPLETO"
"IVONE PEDROSO DE MORAES ASSALIN"	"SUPERIOR COMPLETO"
"JOSE GERALDO COLOMBINI"	"SUPERIOR COMPLETO"
"DAIANA ROBERTA DOS SANTOS PIMENTA"	"SUPERIOR COMPLETO"
"SERGIO LUIZ DE OLIVEIRA"	"SUPERIOR COMPLETO"
"RENATO BARALDI ROMANO"	"SUPERIOR COMPLETO"
"MARCUS VINICIUS PARENTE QUERIDO AZEVEDO"	"SUPERIOR COMPLETO"
"ANDREA MARIA VIANA"	"SUPERIOR COMPLETO"
"ANTÔNIO JOSÉ DA SILVA LISBÔA"	"SUPERIOR COMPLETO"
"VALÉRIA DA SILVA LOPES"	"SUPERIOR COMPLETO"
"ACACIO SERGIO RIBEIRO SILVA"	"SUPERIOR COMPLETO"
"LUZ MARINA DE OLIVEIRA COSTA DE ANDRADE"	"SUPERIOR COMPLETO"
"JESSICA QUALIA DOS SANTOS OLIVEIRA ROMUALDO"	"SUPERIOR COMPLETO"
"ANTONIO CARLOS AMADEU"	"SUPERIOR COMPLETO"
"CARLOS ALBERTO SANTA ROSA FILHO"	"SUPERIOR COMPLETO"
"JOSE ARAUJO FILHO"	"SUPERIOR COMPLETO"
"JULIANA FERREIRA MAGNABOSCO"	"SUPERIOR COMPLETO"
"BEATRIZ HELENA ROSA"	"SUPERIOR COMPLETO"
"SILVIA HELENA FRANCISCO FREITAS"	"SUPERIOR COMPLETO"
"CARLOS ANDRÉ CASALLI"	"SUPERIOR COMPLETO"
"ALBERTO ZOGBI FILHO"	"SUPERIOR COMPLETO"
"SILVIA MARIA PALHARES MUSSI"	"SUPERIOR COMPLETO"
"ANTONIO DONIZETE MARCELINO"	"SUPERIOR COMPLETO"
"CARLA ROBERTA NOGUEIRA"	"SUPERIOR COMPLETO"
"ELIANE CRISTINA CASTELANI DA SILVA"	"SUPERIOR COMPLETO"
"NILSON DAS NEVES RODRIGUES JUNIOR"	"SUPERIOR COMPLETO"
"LUIZ GUSTAVO RONCHI DOS SANTOS"	"SUPERIOR COMPLETO"
"LUCIANO APARECIDO CANDIDO"	"SUPERIOR COMPLETO"
"ANTONIO CARLOS DE OLIVEIRA"	"SUPERIOR COMPLETO"
"ADILSON DE CAMPOS SALES"	"SUPERIOR COMPLETO"
"LUCAS SILVA DE FREITAS"	"SUPERIOR COMPLETO"
"RONALDO ADRIANO COELHO DE BRITTO"	"SUPERIOR COMPLETO"
"FLAVIO BALBINO"	"SUPERIOR COMPLETO"
"ALTOMIR BERNARDO DA SILVA"	"SUPERIOR COMPLETO"
"DAIANA MARA BAPTISTA"	"SUPERIOR COMPLETO"
"DEISE GILABERTI SANTIAGO SANTOS"	"SUPERIOR COMPLETO"
"GUSTAVO MAXIMIANO RODRIGUES DE OLIVEIRA"	"SUPERIOR COMPLETO"
"ANTONIO EDUARDO MARÇON NOGUEIRA"	"SUPERIOR COMPLETO"
"JOSÉ ANDERSON PEREIRA DOS SANTOS"	"SUPERIOR COMPLETO"
"GABRIELA CASTILHO GONÇALVES DE OLIVEIRA"	"SUPERIOR COMPLETO"
"WILLIAN ROMEIRO CALIXTO"	"SUPERIOR COMPLETO"
"EURICO SASSI FILHO"	"SUPERIOR COMPLETO"
"PAULINO TREVISAN"	"SUPERIOR COMPLETO"
"KARINA APARECIDA DE SOUSA SILVA TODERO"	"SUPERIOR COMPLETO"
"ROQUE CIACO NETO"	"SUPERIOR COMPLETO"
"RAPHAEL SELES DE AQUINO"	"SUPERIOR COMPLETO"
"NIVALDO SANTOS"	"SUPERIOR COMPLETO"
"FABIANA SANDOVAL"	"SUPERIOR COMPLETO"



6)

SELECT can.nm_candidato,par.sg_partido
FROM candidato can, partido par
WHERE can.nm_ue = 'CUIABÁ' AND can.nr_partido = par.nr_partido

"PAULO DE CAMPOS BORGES JUNIOR"	"PSDB"
"BENEDITO CEDRONIAS DE ALMEIDA"	"NOVO"
"ANA PAULA LEIRIA SILVA"	"UNIÃO"
"VANDERLEI SILVA DOS REIS"	"PP"
"ERIKA DEISMAN VILELA BITES"	"SOLIDARIEDADE"
"PAULO CESAR E SILVA"	"REPUBLICANOS"
"BELCHIOR CAMILO DA SILVA"	"DC"
"ELEUS VIEIRA DE AMORIM"	"PRTB"
"MARCIO RODRIGUES DA COSTA"	"PODE"
"CASSIO ROBERTO URBANO FRANÇA"	"PRTB"
"EDIVALDO ROCHA DOS SANTOS"	"CIDADANIA"
"PAULINO SEBASTIÃO DE ARRUDA"	"SOLIDARIEDADE"
"FLÁVIA MESQUITA GONÇALVES"	"PP"
"GILBERTO LOPES FILHO"	"PMB"
"MARIA DO CARMO MOREIRA OLIVEIRA AVALONE"	"PSDB"
"JEFFERSON LUIS DALTRO MONTEIRO DA SILVA"	"CIDADANIA"
"KALIL JORGE ZATTAR DE ARRUDA CARVALHO"	"PDT"
"BENEDITA CANDIDA DA SILVEIRA"	"PP"
"JULIANE NUNES DA SILVA"	"PV"
"CARLOS FREDERICCO REINERS GAHYVA"	"REPUBLICANOS"
"EUDO PEREIRA DA SILVA"	"REDE"
"CARLOS RAFAEL DEMIAN GOMES DE CARVALHO"	"REPUBLICANOS"
"THIAGO WILLIAN GOMES SANT ANA"	"CIDADANIA"
"MARCIONE MENDES DE PINHO"	"PMB"
"MARCIA PEREIRA SARDINHA"	"NOVO"
"RENATO FERREIRA DE SANTANA LARA"	"REPUBLICANOS"
"FERNANDES GOMES DE SOUZA"	"DC"
"PAULO JOSE SIQUEIRA RIBEIRO"	"PL"
"ANTÔNIO MARCOS DERMINIO"	"UNIÃO"
"ANA MARIA BATISTA NELSON"	"PMB"
"ARIEL CAMARGO TRENTINI"	"DC"
"JULIANO NARDEZ BRANCO"	"PRTB"
"MARCREAN DOS SANTOS SILVA"	"MDB"
"LORRAYNE GOMES DE ANDRADE PIMENTA"	"NOVO"
"RODRIGO DE SANTA ANA"	"PMB"
"CESAR LIMA DO NASCIMENTO"	"PODE"
"GABRIEL GUILHERME OLIVEIRA VELOSO"	"REPUBLICANOS"
"DAOUD MOHD KHAMIS JABER ABDALLAH"	"UNIÃO"
"ABNER BUENO DE ALMEIDA"	"PSD"
"LEIVA MARIA LOPES"	"PSD"
"NÉVITON FAGUNDES MORAES"	"PP"
"ALEXANDRE PINTO LIBERATTI"	"REDE"
"SUZELI CHRISTIANE SOARES GONCALVES"	"MDB"
"DOMINGOS KENNEDY GARCIA SALES"	"MDB"
"APARECIDA ALDAIR FREITAS RODRIGUES DE MORAIS"	"SOLIDARIEDADE"
"BARBARA SANTOS DUTRA SILVA"	"PODE"
"MARCIO DEODATO CORREIA"	"PSD"
"LUIZ FERNANDO GUIMARÃES DE AMORIM"	"UNIÃO"
"ABILIO JACQUES BRUNINI MOUMER"	"PL"
"KASSIO EDUARDO DA SILVA COELHO"	"PODE"
"THIAGO HENRIQUE MARQUES DOS ANJOS"	"PSDB"
"ZORAIDE SANTOS QUEIROZ XAVIER"	"MDB"
"DELVI LINS"	"DC"
"MARIA RITA BRANDÃO PEREIRA"	"UNIÃO"
"LEOVALDO CASTRO DE CAMPOS"	"DC"
"JOAO ADEVILSON DE SOUZA"	"CIDADANIA"
"MARCELO PIRES DE SOUZA"	"PMB"
"MARIA JOSÉ ALVES COSTANESKI"	"PSD"
"RONALDO JESUS BISPO FIGUEIREDO"	"PSD"
"WELITON DIVINO DE ALMEIDA"	"REPUBLICANOS"
"BARBARA ANDREYA HIDALGO REIS RODRIGUES SILVA"	"PODE"
"ROBERTINO FRANCISCO SOBRINHO"	"PDT"
"VANIA RIBEIRO BARBOSA"	"PSOL"
"LUIZ ANTONIO GIROLDO FILHO"	"PRTB"
"KLLAUS CESAR SOUZA DOS SANTOS"	"PODE"
"MARIA APARECIDA DA SILVA"	"REPUBLICANOS"
"PAULO HENRIQUE DE FIGUEIREDO"	"MDB"
"MARCOS ANTONIO RIBEIRO DA CRUZ"	"DC"
"ACHILLE SOTIRIOS LIAMBOS NETO"	"UNIÃO"
"MARCO AURÉLIO RIBEIRO COELHO JUNIOR"	"SOLIDARIEDADE"
"CONCEICAO APARECIDA DA CRUZ COSTA"	"PRTB"
"ALESSANDRA TEIXEIRA COELHO"	"DC"
"MARIA DA COSTA MAGALHÃES"	"PC do B"
"JOSÉ DOMINGUÊS DE GODOI NETO"	"PP"
"EDEMIR CLAUDIO XAVIER"	"PODE"
"ALUÍZIO LEITE PAREDES"	"PV"
"ANTONIO CARLOS DE JESUS FERNANDES"	"PSOL"
"JOSÉ DE OLIVEIRA LIMA"	"PSOL"
"JOSÉ CEZAR NASCIMENTO"	"UNIÃO"
"CARLOS FRANCISCO RODRIGUES DA COSTA"	"UNIÃO"
"MARA RÚBIA GARCIA BADAN"	"PDT"
"CASSIA CRISTINA PEDROSO"	"PDT"
"JUAREZ PEREIRA VIDAL"	"MDB"
"EDMIRSON FERNANDES DE MAGALHAES"	"REPUBLICANOS"
"FABIO MARTINS DEFANTI"	"PP"
"VICTOR HUGO ALVES"	"PSB"
"JOELSON FERNANDES DO AMARAL"	"PSB"
"KATIUSCIA MANTELI ANDRADE DE TOLEDO"	"PSB"
"MARIA EDUARDA DE FRANÇA MOLINA"	"PSB"
"CLAUDIA MAURICIA LOPES"	"DC"
"EDLEUSA AFONSO DE MESQUITA FILGUEIRAS"	"UNIÃO"
"TANIA MENDES SANTIAGO"	"PRTB"
"RONEY JOSÉ SALLES DE OLIVEIRA"	"REDE"
"EMIDIO ANTONIO DE SOUZA"	"PT"
"DILLON CAPOROSSI"	"SOLIDARIEDADE"
"LUIS FERNANDO OLIVEIRA DIAS"	"CIDADANIA"
"RAQUEL SOUZA MACIEL GRIGOLETO"	"PL"
"VALDEMIR BERNARDINO DA SILVA"	"UNIÃO"
"NILSON NERES REIS SOUZA"	"PV"
"VILSON JOSÉ NEVES DA CRUZ"	"PP"
"MARIA SOCORRO FILHA VERONEZ"	"PMB"
"JUAREZ FRANÇA VENTURA DA ROCHA"	"MDB"
"FANIZE ALBUES"	"PT"
"LEONARDO RODRIGUES DOMICIANO"	"PSDB"
"DEYWISON PAULA DE MORAES"	"PMB"
"ALBERT EINSTEIN PINTO DE ARRUDA"	"PSD"
"GABRIEL CESAR RICAS LEITE"	"UNIÃO"
"DÚBIA BEATRIZ OLIVEIRA CAMPOS"	"PP"
"MAYSA DO PRADO LEÃO GOMES"	"REPUBLICANOS"
"LUCIANA JUCÁ DE OLIVEIRA"	"UNIÃO"
"RONIE PETERSON DIAS DA GUIA"	"NOVO"
"MAYRA CAROLINE PUGSLEY DO PRADO CURVO"	"PODE"
"WESLEY ALVES DE SOUZA"	"PDT"
"OSCARLINO ALVES DE ARRUDA JUNIOR"	"PODE"
"MATEUS VINICIOS FUIM DOS REIS"	"NOVO"
"AMAURI PEREIRA DE ALMEIDA"	"DC"
"JOSÉ PAULO DIAS ROBERTO DE PAULA"	"PSB"
"ROSELI NUNES DA SILVA BARRANCO"	"PT"
"ALEXSSANDRO MIRANDA FRAGA"	"UNIÃO"
"STEPHANIE ROSA JACOMO"	"PODE"
"ROBSON FERREIRA LEÃO"	"MDB"
"MARIA DARLING RODRIGUES"	"PSB"
"DILEMARIO DO VALE ALENCAR"	"UNIÃO"
"EMANUELE PINHEIRO MONTEIRO"	"PODE"
"ILIZETH LUIZA COENGA FERREIRA"	"UNIÃO"
"RENAN ARAUJO TAQUES DE CARVALHO"	"PRTB"
"LUIZ HENRIQUE BOTELHO SENFF"	"SOLIDARIEDADE"
"NEWTON CESAR PEREIRA"	"DC"
"SORAYA MARIA CANDIDA DO AMARAL"	"PP"
"SILBAYNE LOUISE PEREIRA DE MOURA SILVA"	"CIDADANIA"
"JOSÉ EDUARDO BOTELHO"	"UNIÃO"
"LÚDIO FRANK MENDES CABRAL"	"PT"
"LEONARDO RONDON DE SOUZA"	"PT"
"EDJANE BRITO GARCIA BOTELHO DA SILVA"	"PMB"
"JOSE ABEL DO NASCIMENTO"	"PV"
"LUIS CARLOS NUNES RONDON"	"REPUBLICANOS"
"ANDREA APARECIDA LUZ DE ALMEIDA BARROS"	"PL"
"ROSANA SELMA DA SILVA"	"PODE"
"ELIAMARA ZEFERINI DE ARAUJO"	"PODE"
"RAFAEL DA SILVA YONEKUBO"	"PL"
"CARLA FAHIMA NARCAY MILAS"	"PSB"
"ADMILSON ANTONIO DE ASSIS"	"PMB"
"DEMILSON NOGUEIRA MOREIRA"	"PP"
"RAFAELA VENDRAMINI FÁVARO"	"PSD"
"JESSICA ROCHA VIEIRA"	"PRTB"
"SINGLAIR CIEKALSKI DE MUSIS"	"MDB"
"JAQUE DOUGLAS NUNES DINIS"	"NOVO"
"GUSTAVO PADILHA PINTO SILVA"	"PSB"
"JEFERSON DE SOUZA SIQUEIRA"	"PSD"
"CLAUDIA FATIMA DE SALES"	"NOVO"
"ADJAIR PEREIRA DOS SANTOS"	"PSD"
"ANGELO MARCIO DELLA ROVERE"	"PODE"
"MARCELO EDUARDO BUSSIKI RONDON"	"UNIÃO"
"CLEO DA COSTA"	"SOLIDARIEDADE"
"MARCIO DE BULHOES ARAUJO"	"PMB"
"AMANDA BORGES DE SA"	"DC"
"CASSIMIRO DA SILVA FILHO"	"DC"
"CRISTIANE DE ALMEIDA LARA"	"DC"
"ROGERIO RAMOS VARANDA"	"PSDB"
"JENNIFER DANIELE DA SILVA MEZZOMO"	"PODE"
"RAFAEL BEAL RANALLI"	"PL"
"JOSANE MARIA DIAS NASCIMENTO GONÇALVES"	"PSD"
"NILSON PORTELA FERREIRA"	"PSB"
"MARCIA DE SOUZA CARDOSO"	"PV"
"ZILEIDE LUCINDA DOS SANTOS"	"PSD"
"VILMA PAULA BARROS DE ASSIS"	"PSB"
"MARCELO CONCEIÇÃO DA CUNHA"	"PSB"
"JOSÉ ROBERTO DE FREITAS CAVALCANTE"	"PSOL"
"JULIETE GOMES DA SILVA ANGELIM"	"PSDB"
"ALIZANGELA DE SOUZA"	"SOLIDARIEDADE"
"IRAPUA FERREIRA DE CARVALHO"	"PRTB"
"ROBERTO FERNANDES DA SILVA"	"SOLIDARIEDADE"
"GUILHERME OLIVEIRA DE ALMEIDA"	"UNIÃO"
"JOSÉ MENEZES SIQUEIRA"	"PMB"
"RAPHAEL ALVES BRUNINI"	"PRTB"
"LÍGIA CRISTIANE ARFELI"	"PP"
"DEVAIR RODRIGUES RIBEIRO"	"PMB"
"GIORGIO AGUIAR DA SILVA"	"REPUBLICANOS"
"HELIO MARCELO PESENTI SANDRIN"	"REPUBLICANOS"
"ANDRE CRISTHIANO OLIVEIRA DA SILVA"	"PODE"
"EDUARDO JOÃO DE ARAÚJO"	"SOLIDARIEDADE"
"JANETE IZIDORIO DA SILVA ALVES DOS SANTOS"	"PDT"
"MAYCON DOUGLAS ALVES DA SILVA"	"PSD"
"IZAQUE DO NASCIMENTO ROSA"	"PP"
"JOEDER SILVA BARBALHO"	"PODE"
"JOÃO PEDRO PIMENTA"	"PRTB"
"SAMANTHA IRIS BELARMINO CRISTOVAO"	"PL"
"RAFIC MOHAMAD YASSINE"	"PP"
"ANDREIA LIMA DA SILVA"	"PSOL"
"HELISAINE CRISTINI RIBEIRO"	"NOVO"
"REGINALDO SILVA DE ARAUJO"	"PT"
"ADVAIR ALVES DA FONSECA"	"MDB"
"DEMILSON DA SILVA SOARES"	"PRTB"
"SAMARA BASTOS COSTA"	"DC"
"NELSON DE FARIA"	"PP"
"VINICYUS CORRÊA HUGUENEY"	"PP"
"FERNANDO ALENCAR BEZERRA"	"PMB"
"NASSER HUSSEIN FARES"	"MDB"
"JOSE EDUARDO DE FARIA JUNIOR"	"PP"
"DANIEL SOUZA SILVA MONTEIRO"	"REPUBLICANOS"
"DIANA CATARINA SOUZA"	"PSDB"
"NATALICIO CARVALHO SANTOS"	"NOVO"
"WILSON NONATO SILVA"	"PMB"
"APARECIDA MARIA DE FIGUEIREDO"	"SOLIDARIEDADE"
"CLEBIO ROSA BORGES"	"DC"
"MARIANA STAPHANY RIBEIRO CARVALHO CRAUS"	"PL"
"RONALDO ARNALDO DA SILVA"	"PMB"
"ELIANE ABREU LIMA"	"MDB"
"LUIZ FERNANDO RODRIGUES DE SOUZA"	"NOVO"
"EDILENE CÂNDIDA RIBEIRO"	"REDE"
"ARIOVALDO MUNDIM"	"PODE"
"EMANUEL ALMEIDA LIBOS DAUBIAN"	"PL"
"ARTHUR FABIANO GARCIA E SILVA"	"NOVO"
"ADRIANO BATISTA"	"NOVO"
"GILIANE TAINÁ ALVES DA CRUZ NEVES"	"PDT"
"JOSÉ AUGUSTO DE CAMPOS"	"PSB"
"MARCIA CRISTINA DA SILVA"	"UNIÃO"
"ONILCE HELENA DO NASCIMENTO"	"PRTB"
"SORAYA FERREIRA DA SILVA"	"NOVO"
"JULIO CESAR MAIA PEREIRA"	"REPUBLICANOS"
"ENELINDA MARIA APARECIDA DOS SANTOS SCALA"	"PT"
"GUILHERME VINICIUS FERREIRA DE OLIVEIRA"	"PODE"
"ELIAS PEREIRA DOS SANTOS FILHO"	"SOLIDARIEDADE"
"MARCILENE SILVA SANTANA"	"PODE"
"CLAUDIANE HELENA DO ROSARIO LORENZON"	"CIDADANIA"
"RUBENS DIAS DA SILVA"	"PDT"
"WANDERSON DOS SANTOS OLIVEIRA"	"PP"
"ROSILENI SOARES DA COSTA"	"PT"
"SILVIA MARIA PAPI SANTANA"	"PRTB"
"MIRIAM CALAZANS DOS SANTOS"	"PDT"
"WELINGTON GOMES BEZERRA DE OLIVEIRA"	"PRTB"
"RUSTISON PEDROSO"	"UNIÃO"
"MAURÍCIO DA COSTA"	"SOLIDARIEDADE"
"MARILDA FATIMA GIRALDELLI"	"SOLIDARIEDADE"
"RENIVALDO ALVES DO NASCIMENTO"	"PSDB"
"WANIA GRACIA AMORIM LIMA"	"REDE"
"RODRIGO OLIVEIRA DE ARRUDA E SA"	"PSDB"
"SILVANIO DA SILVA CRUZ"	"PMB"
"ROSANA DE MELO XAVIER"	"PP"
"MAYARA CRISTINA CINTRA ROSA FRANCO"	"REPUBLICANOS"
"CREONI DA SILVA DIAS"	"PRTB"
"WALDEMIR ALVES PEREIRA"	"NOVO"
"ALDNAIR BEZERRA DA SILVA"	"NOVO"
"JANETE AUXILIADORA SOARES DE FRANÇA"	"REPUBLICANOS"
"JESSICA BRUNA QUEIROZ DE ARAUJO"	"PSDB"
"ROBERTO MIRANDA PITA"	"PSD"
"MARINA FIGUEIREDO REIS"	"PL"
"DANIEL LUIS PADILHA E SILVA"	"PL"
"DÍDIMO DA SILVA RODRIGUES"	"PSB"
"RENATO DA SILVA MOTA"	"PMB"
"CAROLINA GUIMARÃES SANTOS"	"PSOL"
"ROBERTO CESAR DA SILVA"	"PL"
"JESSE RODRIGUES DE ARRUDA BARROS"	"DC"
"EDUARDO TADEU PEIXOTO"	"UNIÃO"
"ANDREIA SCHWARZ SANTOS SILVA"	"PDT"
"IRENE MESSIAS DA SILVA"	"REDE"
"RODRIGO GUILHERME DO CARMO DA SILVA SOUZA"	"PL"
"PATRICIA GLAURA DE ARAÚJO CAMPOS"	"REPUBLICANOS"
"ZIDIEL INFANTINO COUTINHO JUNIOR"	"SOLIDARIEDADE"
"LEANDRO RODRIGO FIGUEIREDO DE OLIVEIRA"	"PL"
"EDLAINE DA SILVA MAIA AGUIAR"	"PRTB"
"WILLIAN COSTA CAMPOS"	"UNIÃO"
"MARCUS ANTONIO DE SOUZA BRITO JUNIOR"	"PV"
"KEROLAINE LIMA DE OLIVEIRA ARAUJO"	"PRTB"
"DANIELLE PEREIRA DA SILVA NASCIMENTO"	"SOLIDARIEDADE"
"ROBINSON CIREIA DE OLIVEIRA"	"PT"
"FABIO BARBOSA SENA"	"REPUBLICANOS"
"MARICELMA CRISTINA LOUZADO DE ALMEIDA"	"MDB"
"ELGA VICUNA ARRUDA FIGUEIREDO"	"PSB"
"MARIA FRANCISCA SILVA"	"PL"
"THIAGO CHAGAS DE MORAES BERGAMINI"	"MDB"
"RONAN OLIVEIRA ITACARAMBY FILHO"	"PSDB"
"LEONARDO GONZALES DE OLIVEIRA RIBEIRO"	"UNIÃO"
"MARIA AUXILIADORA DA COSTA SPADINI"	"PSDB"
"MARLUCE BENEDITO DE OLIVEIRA"	"DC"
"ELI CARLOS OLIVEIRA ARAUJO"	"PL"
"MIRIAM DE OLIVEIRA"	"PV"
"OSVALDO DE SOUZA BRITO"	"DC"
"GABRIEL GONCALVES DE MIRANDA"	"DC"
"CLAUDIO DE RODRIGUES CARNEIRO"	"PP"
"MARCUS FABRÍCIO NUNES DOS SANTOS"	"PDT"
"MARIA DE FATIMA DA CONCEICAO"	"REPUBLICANOS"
"JOSE SIRLEI ROZA DE LIMA"	"NOVO"
"NATALICOL DO NASCIMENTO MARQUES"	"SOLIDARIEDADE"
"JOANA DARC DE AMORIM NASCIMENTO"	"PODE"
"JOVANIL PEDRO CRUZ"	"PSD"
"MARIA JOSÉ DE OLIVEIRA ARRUDA"	"PL"
"YURE ALVES MIRANDA"	"DC"
"ADEVAIR BATISTA CABRAL"	"SOLIDARIEDADE"
"MARIMAX DA SILVA ALMEIDA"	"UNIÃO"
"HELENA MARIA DO NASCIMENTO"	"PSD"
"NELSON JOSÉ DA SILVA JUNIOR"	"PODE"
"REGIS PRADO NASCIMENTO"	"REPUBLICANOS"
"OSCEMÁRIO FORTE DALTRO"	"PODE"
"MARCIO NERIS DA SILVA"	"PSD"
"SIMONE MARIA MANO DE INCROCCI"	"PMB"
"ROSILEY NUNES RODRIGUES LEITE"	"DC"
"RENILDO SOARES DE FRANÇA"	"PODE"
"ERLON RODRIGUES PEREIRA"	"PMB"
"SAMER ROGER MOREIRA DA SILVA"	"REPUBLICANOS"
"ADRIANE MARTINS DA SILVA"	"PSB"
"ILDEFONSO TAQUES DE LUCENA FILHO"	"PSB"
"HUDSON EDWARD PINHEIRO"	"PL"
"JUCELMA OLIVEIRA DA SILVA"	"PSD"
"ALESSANDRO CASTRO DA SILVA"	"PRTB"
"ODAIR OROZIMBO MEDEIROS"	"DC"
"JOANA D ARC BARONI"	"DC"
"SANDRA DA SILVA BARBOSA"	"PRTB"
"ALDEMIR OLIVEIRA SANTOS FILHO"	"CIDADANIA"
"DEBORA CRISTINA JARRETA DE OLIVEIRA"	"SOLIDARIEDADE"
"JUNIOR LIMA DA SILVA"	"REPUBLICANOS"
"DOMINIQUE MOURA BIANCARDINI"	"UNIÃO"
"FELLIPE PEREIRA CORREA"	"PL"
"MARCOS VINICIUS LEVY"	"PSD"
"JONAS DA SILVA CABANHA"	"SOLIDARIEDADE"
"ERON NUNES CABRAL"	"REDE"
"FRANCISCO CARLOS AMORIM SILVEIRA"	"PL"
"ERVESON JONES PEREIRA DE SOUZA"	"MDB"
"VICENTE VUOLO"	"PODE"
"REGINA DOS SANTOS COSTA FERRAZ SOARES"	"PSB"
"ALEX RODRIGUES"	"PV"
"SÉRGIO RODRIGUES DA SILVA"	"SOLIDARIEDADE"
"JULIER SEBASTIÃO DA SILVA"	"PT"
"JOSÉ ADVAIR RIBEIRO"	"PSD"
"JOSÉ DE LIMA ARAUJO QUEIROZ"	"PMB"
"PLÍNIO PERIOLO PADILHA JUNIOR"	"SOLIDARIEDADE"
"CLEMENTINO GOMES"	"PSD"
"EMANUELLE KAROLINA VICTOR SOARES"	"PMB"
"APARECIDA RIBEIRO DE OLIVEIRA"	"PDT"
"JEFFERSON CARVALHO MONTEIRO"	"PRTB"
"JEAN MARCEL DE ALMEIDA BARROS"	"PSB"
"ADALBERTO AUGUSTO CAVALCANTE DA SILVA"	"MDB"
"CRISTIANO NOGUEIRA PERES PREZA"	"DC"
"PAULO CESAR MACEDO"	"PDT"
"DIONI RUAN MOTA MARIANO"	"PRTB"
"AMINADABE MATILDES DIAS"	"PRTB"
"CLEBER BENEDITO BAZZANO MORAES"	"NOVO"
"SOLANGE GUIA DA SILVA"	"PSD"
"LAURO BOA SORTE CARNEIRO"	"PSB"
"DEBORA MARQUES VILAR"	"MDB"
"ELIANE SILVA RIBEIRO"	"PMB"
"ISAC POVOAS NETO"	"PDT"
"ANDREILZA GALDINO COSTA"	"UNIÃO"
"LUIZ AUGUSTO GOMES DA SILVA"	"PV"
"THAMYRES DE CARVALHO GALAXE"	"CIDADANIA"
"MARISA HELENA ALVES"	"PSB"
"BENEDITO SANTANA DE ARRUDA"	"PSD"
"EDILSON ROBERTO MENDES DA ROSA"	"PSOL"
"ADAVILSO AZEVEDO DA COSTA"	"PL"
"PAULO SERGIO BORGES DA SILVA"	"NOVO"
"ANDRICO MORAES XAVIER"	"PL"
"ELIAS DO NASCIMENTO GALLI"	"DC"
"GENILSON MARTINS DA SILVA"	"REDE"
"FABRICIO VIEIRA"	"NOVO"
"IRANILDES DIAS DA SILVA"	"PP"
"THAISA FERNANDA FIGUEIREDO LENZI"	"SOLIDARIEDADE"
"MARCO AURELIO VIEGAS DE PINHO"	"PODE"
"RODRIGO POUSO MIRANDA"	"REPUBLICANOS"
"ANTONIO LEMES DE PAULA"	"PSD"
"GUILHERME ROCHA NEVES"	"PP"
"JOSE MARCONDES DE OLIVEIRA JUNIOR"	"PP"
"CLAUDINEY DE OLIVEIRA VIEIRA"	"UNIÃO"
"CLAUDIA AVELINO NOIA"	"PMB"
"PABLO DA SILVA LIMA"	"PRTB"
"RICARDO MURILO DE ARRUDA ALVES"	"PP"
"JURANDIR ZARAMELLO"	"PSD"
"JULIANA GIMENES DE FREITAS"	"REPUBLICANOS"
"CARLA COSTA BRAGA"	"PV"
"SIDNEY DE SOUZA"	"PRTB"
"ADRYA ALMEIDA SOUZA"	"PSB"
"EDILSON ODILON DA SILVA"	"PODE"
"ESTIVE ALEN MARQUES PEREIRA"	"DC"
"LICINIO VIEIRA DE ALMEIDA JUNIOR"	"PP"
"MARIA SANTANA COSTA NEVES SALES"	"REPUBLICANOS"
"CARINE CEPIL GOMES DA COSTA"	"PSDB"
"JANIO FLAVIO DE AMORIM"	"PV"
"LUIZ ALBERTO SILVA DE ALMEIDA JUNIOR"	"SOLIDARIEDADE"
"DIEGO GORDON PADILHA RAMSAY"	"PDT"
"OCIMAR BAIA DE OLIVEIRA"	"REDE"
"JOAQUIM VALADARES LIRA JUNIOR"	"PL"
"JOEL GERALDO DA SILVA"	"NOVO"
"MISAEL OLIVEIRA GALVAO"	"PSD"
"CLEY ROBERTO FERNANDES DA SILVA"	"REPUBLICANOS"
"PABLO RODRIGO QUEIROZ"	"DC"
"OZIANE ALVES RODRIGUES"	"PV"
"THYAGO STEPHANE CORREA"	"PMB"
"THALYSON SILVA BUENO"	"PDT"
"NICASSIO JOSÉ BARBOSA"	"MDB"
"ZÓZIMA DIAS DOS SANTOS"	"NOVO"
"PAULA PINTO CALIL"	"PL"
"CAIUBI EMANUEL SOUZA KUHN"	"PDT"
"ANDRE VICTOR CAZONATO DE MELO"	"DC"
"MARCELO CRAICI"	"PL"
"ÉDIO MARTINS DE SOUZA"	"PSB"
"PAULA PEDROSO RAMOS MORAES DE ALMEIDA"	"PMB"
"PEDRINA MARIA DE SANTANA"	"SOLIDARIEDADE"
"ERIKA FIGUEIREDO SOUZA GAMA"	"PL"
"CLAUDIA PEDROSO DE OLIVEIRA NAZARIO"	"MDB"
"RONALD MUZZI NETO"	"PV"
"ROBERTO GONÇALVES PERON"	"PSB"
"ARIELLE FERREIRA DOS SANTOS"	"NOVO"
"ANA DE FÁTIMA OTHON LEITE SOUZA"	"PP"
"ANDREA JANAINA DE MELLO"	"PSB"
"GIRLAYNNE CARLA DE ALMEIDA SANTOS"	"PMB"
"RAFAEL SILVA DO AMARAL"	"CIDADANIA"
"EDUARDO VICTOR MAGALHÃES"	"REPUBLICANOS"
"ADILSON AMÉRICO MACHADO DE OLIVEIRA"	"PSB"
"MAURO KLEBER RIBEIRO LEITE"	"REDE"
"NATAL MORALECO FILHO"	"PRTB"
"ANDRÉ AUGUSTO SIRICO"	"PC do B"
"GILSON PEREIRA BATISTA"	"PV"
"RAQUEL GONÇALVES DA SILVA BENETOLI"	"REPUBLICANOS"
"RAYRA SILVESTRE SOUZA"	"NOVO"
"JOÃO CUSTÓDIO DA SILVA"	"PT"
"ADMILSON CARDOSO SIMOES"	"PL"
"VANIA GARCIA ROSA"	"NOVO"
"MARCIO SOUZA SANTANA"	"PODE"
"MARTA FERREIRA"	"PL"
"UELLINGTON BOTOF VALENÇA"	"SOLIDARIEDADE"
"WALTER LUIS DA SILVA MATOS"	"PODE"
"FÁBIO DA SILVA OLIVEIRA"	"NOVO"
"MICHELLY DE ALENCAR SANTOS NEVES"	"UNIÃO"
"FRANK ANTONIO GARCIA DUARTE"	"PSD"
"FRANCIVALDO AFONSO VIEIRA"	"DC"
"RICARDO JULIO TOMAZ NETO"	"PCO"
"TEREZINHA BERTINI BUENO"	"CIDADANIA"
"NAZIRA AUXILIADORA DE AMORIM FONSECA"	"PSD"
"MERIELLY CRISTINA NANTES"	"PSB"
"GERALDA MENDES DA SILVA COSTA"	"DC"
"MARIO ANTONIO MOYSES NADAF"	"PV"
"JOVELINA RITA CARDOSO NETA TIZOT"	"PP"
"GILBERTO RODRIGUES TEIXEIRA"	"PSDB"
"ANA CLARICE RODRIGUES DE JESUS"	"DC"
"VANDERSON ALVES NUNES"	"NOVO"
"LEONARDO SABOIA PAES DE BARROS"	"PRTB"
"LAUDICÉRIO AGUIAR MACHADO"	"UNIÃO"
"JULYENE PAOLLA DOS REIS"	"REPUBLICANOS"
"ARI SOARES DE ARAÚJO FILHO"	"PSB"
"JORGE GABRIEL RAMIRES JUNIOR"	"PDT"
"RAUNY ALVES DE OLIVEIRA"	"PDT"
"ALESSANDRA SOUZA REIS"	"PRTB"
"DANIEL ROBERTO DA SILVA"	"PL"
"ODILZA TEREZINHA DA SILVA"	"PV"
"LUIZ WALTER TEIXEIRA DE SOUZA"	"PMB"
"EDNA LUZIA ALMEIDA SAMPAIO"	"PT"
"MARIA INES MARTINS BOTELHO"	"PMB"
"WALDEMIR RODRIGUES DE MATOS"	"NOVO"
"JANDEIVID LOURENÇO MOURA"	"PSB"
"EMANUEL MUSSA AMUI PINHEIRO"	"PP"
"RAIMUNDO NONATO NUNES SILVA"	"DC"
"LUIS CLAUDIO DE CASTRO SODRE"	"MDB"


7)

SELECT DISTINCT gr.ds_grau_instrucao
FROM candidato can, partido par, grau_instrucao gr
WHERE can.sg_uf_nascimento = 'BA' AND par.nr_partido = can.nr_partido AND par.sg_partido = 'PSDB'
      AND can.cd_grau_instrucao = gr.cd_grau_instrucao

"ENSINO FUNDAMENTAL COMPLETO"
"ENSINO FUNDAMENTAL INCOMPLETO"
"ENSINO MÉDIO COMPLETO"
"ENSINO MÉDIO INCOMPLETO"
"LÊ E ESCREVE"
"SUPERIOR COMPLETO"
"SUPERIOR INCOMPLETO"

8)

SELECT can.nm_urna_candidato,can.nr_candidato,par.sg_partido,col.ds_coligacao
FROM candidato can, partido par, coligacao col, cargo carg
WHERE 
(carg.ds_cargo = 'PREFEITO' OR carg.ds_cargo = 'VICE-PREFEITO') AND
(can.cd_cargo = carg.cd_cargo) AND
(can.nm_ue = 'SÃO PAULO' OR can.nm_ue = 'RIO DE JANEIRO' OR can.nm_ue = 'VITÓRIA' OR can.nm_ue = 'BELO HORIZONTE')AND (can.sq_coligacao = col.sq_coligacao) AND
(can.nr_partido = par.nr_partido)


"VICTOR RICCIARDI ROCHA"	45	"UNIÃO"	"Federação PSDB CIDADANIA(PSDB/CIDADANIA) / UNIÃO / PSB / PMB / MDB"
"POPO"	30	"NOVO"	"NOVO"
"LUIZ PAULO VELLOZO LUCAS"	45	"PSDB"	"Federação PSDB CIDADANIA(PSDB/CIDADANIA) / UNIÃO / PSB / PMB / MDB"
"LORENZO PAZOLINI"	10	"REPUBLICANOS"	"PSD / REPUBLICANOS / PP / PRD / NOVO / DC"
"DATENA"	45	"PSDB"	"Federação PSDB CIDADANIA(PSDB/CIDADANIA)"
"LUCIA FRANÇA"	40	"PSB"	"PSB"
"EDUARDO PAES"	55	"PSD"	"PODE / PRD / DC / AGIR / SOLIDARIEDADE / AVANTE / PSB / PDT / Federação BRASIL DA ESPERANÇA - FE BRASIL(PT/PC do B/PV) / PSD"
"FRED PACHECO"	44	"MOBILIZA"	"MOBILIZA / UNIÃO"
"TABATA AMARAL"	40	"PSB"	"PSB"
"BEBETO HADDAD"	27	"DC"	"DC"
"CORONEL PRIELL"	30	"NOVO"	"NOVO"
"EDUARDO CAVALIERE"	55	"PSD"	"PODE / PRD / DC / AGIR / SOLIDARIEDADE / AVANTE / PSB / PDT / Federação BRASIL DA ESPERANÇA - FE BRASIL(PT/PC do B/PV) / PSD"
"MARTA SUPLICY"	50	"PT"	"Federação PSOL REDE(PSOL/REDE) / Federação BRASIL DA ESPERANÇA - FE BRASIL(PT/PC do B/PV) / PDT"
"GERALDO NERES"	80	"UP"	"UP"
"SILVANA GARCIA"	16	"PSTU"	"PSTU"
"TARCÍSIO MOTTA"	50	"PSOL"	"Federação PSOL REDE(PSOL/REDE) / PCB"
"ANTONIA DE JESUS"	28	"PRTB"	"PRTB"
"DUDA SALABERT"	12	"PDT"	"PDT"
"MARINA HELENA"	30	"NOVO"	"NOVO"
"ASSUMÇÃO"	22	"PL"	"AGIR / MOBILIZA / PL"
"LOURDES FRANCISCO"	29	"PCO"	"PCO"
"TERESA BERGHER"	11	"PP"	"PP / Federação PSDB CIDADANIA(PSDB/CIDADANIA)"
"ÍNDIA ARMELAU"	22	"PL"	"PL / MDB / REPUBLICANOS"
"GABRIEL"	15	"MDB"	"MDB / PSB"
"JULIA SOARES"	80	"UP"	"UP"
"CAROL SPONZA"	30	"NOVO"	"NOVO"
"WANDERSON ROCHA"	16	"PSTU"	"PSTU"
"MARCELO QUEIROZ"	11	"PP"	"PP / Federação PSDB CIDADANIA(PSDB/CIDADANIA)"
"BENEVIDES CAMELO"	80	"UP"	"UP"
"PAULA FALCÃO"	16	"PSTU"	"PSTU"
"CORONEL CLAUDIA"	22	"PL"	"PP / PL"
"RICARDO SENESE"	80	"UP"	"UP"
"ALEXANDRE RAMAGEM"	22	"PL"	"PL / MDB / REPUBLICANOS"
"DU"	70	"AVANTE"	"PRTB / AVANTE / SOLIDARIEDADE"
"RENATA ROSA"	20	"PODE"	"PODE / MOBILIZA / DC / PRTB"
"ALTINO PRAZERES"	16	"PSTU"	"PSTU"
"JOÃO COSER"	13	"PT"	"Federação BRASIL DA ESPERANÇA - FE BRASIL(PT/PC do B/PV) / PDT"
"FUAD NOMAN"	55	"PSD"	"SOLIDARIEDADE / UNIÃO / PRD / PSD / AGIR / AVANTE / Federação PSDB CIDADANIA(PSDB/CIDADANIA)"
"ALVARO DAMIAO"	55	"UNIÃO"	"SOLIDARIEDADE / UNIÃO / PRD / PSD / AGIR / AVANTE / Federação PSDB CIDADANIA(PSDB/CIDADANIA)"
"LUISA BARRETO"	10	"NOVO"	"REPUBLICANOS / NOVO"
"ANDRÉA FERREIRA"	16	"PSTU"	"PSTU"
"CARLOS VIANA"	20	"PODE"	"PODE / MOBILIZA / DC / PRTB"
"PABLO MARÇAL"	28	"PRTB"	"PRTB"
"CAETANO ALBUQUERQUE"	29	"PCO"	"PCO"
"PAULO BRANT"	15	"PSB"	"MDB / PSB"
"MARÍLIA GARCIA"	29	"PCO"	"PCO"
"CORONEL MELLO ARAUJO"	15	"PL"	"PP / MDB / PL / PSD / REPUBLICANOS / SOLIDARIEDADE / PODE / AVANTE / PRD / AGIR / MOBILIZA / UNIÃO"
"CAMILA CONSCI"	27	"DC"	"DC"
"JULIETE PANTOJA"	80	"UP"	"UP"
"RENATA SOUZA"	50	"PSOL"	"Federação PSOL REDE(PSOL/REDE) / PCB"
"JOSE ANIBAL"	45	"PSDB"	"Federação PSDB CIDADANIA(PSDB/CIDADANIA)"
"JOÃO PIMENTA"	29	"PCO"	"PCO"
"RODRIGO AMORIM"	44	"UNIÃO"	"MOBILIZA / UNIÃO"
"CYRO GARCIA"	16	"PSTU"	"PSTU"
"CRIS SAMORINI"	10	"PP"	"PSD / REPUBLICANOS / PP / PRD / NOVO / DC"
"MACACIEL BREDA"	50	"REDE"	"Federação PSOL REDE(PSOL/REDE)"
"PROFESSOR FRANCISCO FOUREAUX"	12	"PDT"	"PDT"
"RICARDO NUNES"	15	"MDB"	"PP / MDB / PL / PSD / REPUBLICANOS / SOLIDARIEDADE / PODE / AVANTE / PRD / AGIR / MOBILIZA / UNIÃO"
"MAURO TRAMONTE"	10	"REPUBLICANOS"	"REPUBLICANOS / NOVO"
"GUILHERME BOULOS"	50	"PSOL"	"Federação PSOL REDE(PSOL/REDE) / Federação BRASIL DA ESPERANÇA - FE BRASIL(PT/PC do B/PV) / PDT"
"INDIRA XAVIER"	80	"UP"	"UP"
"FRANCISCO MUNIZ"	29	"PCO"	"PCO"
"CAMILA VALADÃO"	50	"PSOL"	"Federação PSOL REDE(PSOL/REDE)"
"CORONEL WAGNER "	70	"PRTB"	"PRTB / AVANTE / SOLIDARIEDADE"
"ROGERIO CORREIA"	13	"PT"	"Federação BRASIL DA ESPERANÇA - FE BRASIL(PT/PC do B/PV) / Federação PSOL REDE(PSOL/REDE) / PCB"
"HENRIQUE SIMONARD"	29	"PCO"	"PCO"
"MAYRA MARCARINI"	22	"PL"	"AGIR / MOBILIZA / PL"
"PRISCILA MANSO"	13	"PV"	"Federação BRASIL DA ESPERANÇA - FE BRASIL(PT/PC do B/PV) / PDT"
"BRUNO ENGLER"	22	"PL"	"PP / PL"
"BELLA GONÇALVES"	13	"PSOL"	"Federação BRASIL DA ESPERANÇA - FE BRASIL(PT/PC do B/PV) / Federação PSOL REDE(PSOL/REDE) / PCB"

9)

SELECT can.nm_candidato, par.sg_partido, bem.ds_tipo_bem_candidato, bem.vr_bem_candidato
FROM candidato can, partido par, bem_candidato bem, cargo car
WHERE car.cd_cargo = can.cd_cargo AND car.ds_cargo = 'PREFEITO'
AND can.nm_ue = 'SÃO PAULO' AND can.sq_candidato = bem.sq_candidato
AND can.nr_partido = par.nr_partido

"JOSE LUIZ DATENA"	"PSDB"	"Apartamento"
"JOSE LUIZ DATENA"	"PSDB"	"Casa"
"JOSE LUIZ DATENA"	"PSDB"	"Terreno"
"JOSE LUIZ DATENA"	"PSDB"	"Terreno"
"JOSE LUIZ DATENA"	"PSDB"	"Terreno"
"JOSE LUIZ DATENA"	"PSDB"	"Terreno"
"JOSE LUIZ DATENA"	"PSDB"	"Terreno"
"JOSE LUIZ DATENA"	"PSDB"	"Outros bens imóveis"
"JOSE LUIZ DATENA"	"PSDB"	"Outros bens imóveis"
"JOSE LUIZ DATENA"	"PSDB"	"Outros bens imóveis"
"JOSE LUIZ DATENA"	"PSDB"	"Quotas ou quinhões de capital"
"JOSE LUIZ DATENA"	"PSDB"	"Depósito bancário em conta corrente no País"
"JOSE LUIZ DATENA"	"PSDB"	"Aplicação de renda fixa (CDB, RDB e outros)"
"JOSE LUIZ DATENA"	"PSDB"	"VGBL - Vida Gerador de Benefício Livre"
"JOSE LUIZ DATENA"	"PSDB"	"VGBL - Vida Gerador de Benefício Livre"
"TABATA CLÁUDIA AMARAL DE PONTES"	"PSB"	"Depósito bancário em conta corrente no País"
"TABATA CLÁUDIA AMARAL DE PONTES"	"PSB"	"Outras aplicações e Investimentos"
"ALBERTO FELIPPE HADDAD FILHO"	"DC"	"Terreno"
"ALBERTO FELIPPE HADDAD FILHO"	"DC"	"Terreno"
"ALBERTO FELIPPE HADDAD FILHO"	"DC"	"Veículo automotor terrestre: caminhão, automóvel, moto, etc."
"ALBERTO FELIPPE HADDAD FILHO"	"DC"	"Quotas ou quinhões de capital"
"ALBERTO FELIPPE HADDAD FILHO"	"DC"	"Terreno"
"ALBERTO FELIPPE HADDAD FILHO"	"DC"	"Dinheiro em espécie - moeda nacional"
"MARINA HELENA CUNHA PEREIRA SANTOS"	"NOVO"	"Apartamento"
"MARINA HELENA CUNHA PEREIRA SANTOS"	"NOVO"	"Casa"
"MARINA HELENA CUNHA PEREIRA SANTOS"	"NOVO"	"Quotas ou quinhões de capital"
"MARINA HELENA CUNHA PEREIRA SANTOS"	"NOVO"	"Aplicação de renda fixa (CDB, RDB e outros)"
"MARINA HELENA CUNHA PEREIRA SANTOS"	"NOVO"	"Fundo de Investimento Imobiliário"
"MARINA HELENA CUNHA PEREIRA SANTOS"	"NOVO"	"Fundos: Ações, Mútuos de Privatização, Invest. Empresas Emergentes, Invest.Participação e Invest. Índice Mercado"
"MARINA HELENA CUNHA PEREIRA SANTOS"	"NOVO"	"Depósito bancário em conta corrente no País"
"MARINA HELENA CUNHA PEREIRA SANTOS"	"NOVO"	"Fundo de Longo Prazo e Fundo de Investimentos em Direitos Creditórios (FIDC)"
"RICARDO SENESE"	"UP"	"Veículo automotor terrestre: caminhão, automóvel, moto, etc."
"RICARDO SENESE"	"UP"	"Aplicação de renda fixa (CDB, RDB e outros)"
"ALTINO DE MELO PRAZERES JUNIOR"	"PSTU"	"Casa"
"PABLO HENRIQUE COSTA MARÇAL"	"PRTB"	"Quotas ou quinhões de capital"
"PABLO HENRIQUE COSTA MARÇAL"	"PRTB"	"Quotas ou quinhões de capital"
"PABLO HENRIQUE COSTA MARÇAL"	"PRTB"	"Quotas ou quinhões de capital"
"PABLO HENRIQUE COSTA MARÇAL"	"PRTB"	"Outras participações societárias"
"PABLO HENRIQUE COSTA MARÇAL"	"PRTB"	"Outras participações societárias"
"PABLO HENRIQUE COSTA MARÇAL"	"PRTB"	"Outras participações societárias"
"PABLO HENRIQUE COSTA MARÇAL"	"PRTB"	"Outras participações societárias"
"PABLO HENRIQUE COSTA MARÇAL"	"PRTB"	"Outras participações societárias"
"PABLO HENRIQUE COSTA MARÇAL"	"PRTB"	"Outras participações societárias"
"PABLO HENRIQUE COSTA MARÇAL"	"PRTB"	"Outras participações societárias"
"PABLO HENRIQUE COSTA MARÇAL"	"PRTB"	"Outras participações societárias"
"PABLO HENRIQUE COSTA MARÇAL"	"PRTB"	"Outras participações societárias"
"PABLO HENRIQUE COSTA MARÇAL"	"PRTB"	"Aplicação de renda fixa (CDB, RDB e outros)"
"PABLO HENRIQUE COSTA MARÇAL"	"PRTB"	"Aplicação de renda fixa (CDB, RDB e outros)"
"PABLO HENRIQUE COSTA MARÇAL"	"PRTB"	"Outras aplicações e Investimentos"
"PABLO HENRIQUE COSTA MARÇAL"	"PRTB"	"Outras aplicações e Investimentos"
"PABLO HENRIQUE COSTA MARÇAL"	"PRTB"	"Outras aplicações e Investimentos"
"PABLO HENRIQUE COSTA MARÇAL"	"PRTB"	"Depósito bancário em conta corrente no País"
"PABLO HENRIQUE COSTA MARÇAL"	"PRTB"	"Depósito bancário em conta corrente no País"
"PABLO HENRIQUE COSTA MARÇAL"	"PRTB"	"Outras aplicações e Investimentos"
"PABLO HENRIQUE COSTA MARÇAL"	"PRTB"	"Outras aplicações e Investimentos"
"PABLO HENRIQUE COSTA MARÇAL"	"PRTB"	"Outras aplicações e Investimentos"
"PABLO HENRIQUE COSTA MARÇAL"	"PRTB"	"Outras aplicações e Investimentos"
"PABLO HENRIQUE COSTA MARÇAL"	"PRTB"	"Outros bens imóveis"
"PABLO HENRIQUE COSTA MARÇAL"	"PRTB"	"Terreno"
"PABLO HENRIQUE COSTA MARÇAL"	"PRTB"	"Prédio comercial"
"RICARDO LUIS REIS NUNES"	"MDB"	"Apartamento"
"RICARDO LUIS REIS NUNES"	"MDB"	"Terreno"
"RICARDO LUIS REIS NUNES"	"MDB"	"Terreno"
"RICARDO LUIS REIS NUNES"	"MDB"	"Terreno"
"RICARDO LUIS REIS NUNES"	"MDB"	"Terreno"
"RICARDO LUIS REIS NUNES"	"MDB"	"Terreno"
"RICARDO LUIS REIS NUNES"	"MDB"	"Terra nua"
"RICARDO LUIS REIS NUNES"	"MDB"	"Prédio residencial"
"RICARDO LUIS REIS NUNES"	"MDB"	"Terreno"
"RICARDO LUIS REIS NUNES"	"MDB"	"Terra nua"
"RICARDO LUIS REIS NUNES"	"MDB"	"Terra nua"
"RICARDO LUIS REIS NUNES"	"MDB"	"Veículo automotor terrestre: caminhão, automóvel, moto, etc."
"RICARDO LUIS REIS NUNES"	"MDB"	"Quotas ou quinhões de capital"
"RICARDO LUIS REIS NUNES"	"MDB"	"Quotas ou quinhões de capital"
"RICARDO LUIS REIS NUNES"	"MDB"	"Quotas ou quinhões de capital"
"RICARDO LUIS REIS NUNES"	"MDB"	"Depósito bancário em conta corrente no País"
"RICARDO LUIS REIS NUNES"	"MDB"	"Caderneta de poupança"
"RICARDO LUIS REIS NUNES"	"MDB"	"Depósito bancário em conta corrente no País"
"RICARDO LUIS REIS NUNES"	"MDB"	"Fundo de Longo Prazo e Fundo de Investimentos em Direitos Creditórios (FIDC)"
"RICARDO LUIS REIS NUNES"	"MDB"	"Fundo de Longo Prazo e Fundo de Investimentos em Direitos Creditórios (FIDC)"
"RICARDO LUIS REIS NUNES"	"MDB"	"Aplicação de renda fixa (CDB, RDB e outros)"
"RICARDO LUIS REIS NUNES"	"MDB"	"Aplicação de renda fixa (CDB, RDB e outros)"
"RICARDO LUIS REIS NUNES"	"MDB"	"Depósito bancário em conta corrente no País"
"RICARDO LUIS REIS NUNES"	"MDB"	"Depósito bancário em conta corrente no País"
"RICARDO LUIS REIS NUNES"	"MDB"	"Depósito bancário em conta corrente no País"
"RICARDO LUIS REIS NUNES"	"MDB"	"Depósito bancário em conta corrente no País"
"RICARDO LUIS REIS NUNES"	"MDB"	"Quotas ou quinhões de capital"
"RICARDO LUIS REIS NUNES"	"MDB"	"Depósito bancário em conta corrente no País"
"RICARDO LUIS REIS NUNES"	"MDB"	"Depósito bancário em conta corrente no País"
"RICARDO LUIS REIS NUNES"	"MDB"	"Depósito bancário em conta corrente no País"
"RICARDO LUIS REIS NUNES"	"MDB"	"Depósito bancário em conta corrente no País"
"RICARDO LUIS REIS NUNES"	"MDB"	"Outras aplicações e Investimentos"
"GUILHERME CASTRO BOULOS"	"PSOL"	"Casa"
"GUILHERME CASTRO BOULOS"	"PSOL"	"Veículo automotor terrestre: caminhão, automóvel, moto, etc."
"GUILHERME CASTRO BOULOS"	"PSOL"	"Aplicação de renda fixa (CDB, RDB e outros)"
"GUILHERME CASTRO BOULOS"	"PSOL"	"Depósito bancário em conta corrente no País"	816.00

10)

SELECT nm_ue
FROM candidato
WHERE dt_nascimento = NULL

Não existem candidatos sem a data de nascimento registrada.

11)


SELECT can.nm_candidato, par.sg_partido, est.ds_estado_civil, ocup.ds_ocupacao
FROM candidato can, partido par, estado_civil est, ocupacao ocup , genero gen, cargo car
WHERE (gen.cd_genero = can.cd_genero) AND
(gen.ds_genero = 'FEMININO') AND
(car.cd_cargo = can.cd_cargo) AND 
(car.ds_cargo = 'PREFEITO') AND
(can.nm_ue = 'SÃO PAULO' OR can.nm_ue = 'RIO DE JANEIRO' OR can.nm_ue = 'VITÓRIA' OR can.nm_ue = 'BELO HORIZONTE') AND
(can.nr_partido = par.nr_partido) AND
(can.cd_estado_civil = est.cd_estado_civil) AND
(can.cd_ocupacao = ocup.cd_ocupacao)

"TABATA CLÁUDIA AMARAL DE PONTES"	"PSB"	"SOLTEIRO(A)"	"DEPUTADO"
"DUDA SALABERT ROSA"	"PDT"	"CASADO(A)"	"DEPUTADO"
"MARINA HELENA CUNHA PEREIRA SANTOS"	"NOVO"	"SOLTEIRO(A)"	"ECONOMISTA"
"LOURDES FRANCISCO DA COSTA"	"PCO"	"DIVORCIADO(A)"	"PROFESSOR DE ENSINO FUNDAMENTAL"
"ANA CAROLINA SPONZA BRAGA"	"NOVO"	"SOLTEIRO(A)"	"ADVOGADO"
"CAMILA COSTA VALADÃO"	"PSOL"	"CASADO(A)"	"DEPUTADO"
"JULIETE PANTOJA ALVES"	"UP"	"SOLTEIRO(A)"	"OUTROS"

12)

SELECT can.nm_candidato, par.sg_partido, est.ds_estado_civil, ocup.ds_ocupacao
FROM candidato can, partido par, estado_civil est, ocupacao ocup , genero gen, cargo car
WHERE (gen.cd_genero = can.cd_genero) AND
(gen.ds_genero = 'FEMININO') AND
(car.cd_cargo = can.cd_cargo) AND 
(car.ds_cargo = 'PREFEITO' OR car.ds_cargo = 'VICE-PREFEITO') AND
(can.nm_ue = 'UBERLÂNDIA') AND
(can.nr_partido = par.nr_partido) AND
(can.cd_estado_civil = est.cd_estado_civil) AND
(can.cd_ocupacao = ocup.cd_ocupacao)

"DANDARA TONANTZIN SILVA CASTRO"	"PT"	"SOLTEIRO(A)"	"DEPUTADO"
"GISLAINE CAIXETA DE QUEIROZ"	"PSTU"	"SOLTEIRO(A)"	"TÉCNICO CONTABILIDADE, ESTATÍSTICA, ECONOMIA DOMÉSTICA E ADMINISTRAÇÃO"
"DAPHINY OLIVEIRA COSTA SILVA"	"PRTB"	"VIÚVO(A)"	"OUTROS"

13)

SELECT can.nm_candidato, can.dt_nascimento
FROM candidato can, partido par
WHERE can.nm_ue = 'UBERLÂNDIA' AND can.nr_partido = par.nr_partido

"GISELE OKUHARA CAMPOS"	"1986-12-31"
"MÁRIO KNICHALLA NETO"	"1983-03-07"
"WANDERSON TELLES DOS SANTOS"	"1985-05-26"
"LUISMAR ALVES DE OLIVEIRA"	"1964-04-13"
"PATRIK BORGES DA SILVA"	"1985-07-21"
"JANE MEIRE ROSA"	"1977-01-16"
"CRISTIANO RODRIGUES DA SILVA"	"1980-10-02"
"GABRIEL MARCELINO MIRANDA"	"1990-02-09"
"AMADO DA SILVA NUNES JÚNIOR"	"1959-06-20"
"PAULO MARCOS DE OLIVEIRA QUITES"	"1979-09-24"
"NATHÁLIA SOUZA PIRES"	"1991-02-17"
"RENATA SILVA DE ANDRADE"	"1980-01-01"
"RONALDO NUNES DE SOUZA"	"1977-01-28"
"NEEMIAS MIQUEIAS SILVA SOARES"	"1989-08-18"
"WANDERLAN PIMENTA DE SOUZA"	"1961-06-06"
"EDIVALDO ALVES FERREIRA"	"1973-02-11"
"MICHELLE MILLA DE OLIVEIRA AMARAL"	"1985-12-12"
"ALEXANDRE DONIZETTI DE SOUZA"	"1981-01-23"
"CACIA MIRIAN NUNES VIEIRA"	"1969-10-11"
"DANUBIO MARQUEZ ANDRADE"	"1971-07-15"
"SARA PRADO DE OLIVEIRA"	"1997-11-26"
"DENISE BATISTA DE MELO"	"1979-07-14"
"KENYA APARECIDA BORGES"	"1972-03-23"
"JONATAS MENDONÇA DE FREITAS JUNIOR"	"1978-12-11"
"JULIANO SCHNEIDER DAS NEVES"	"1984-07-12"
"ADILSON LUIZ DOS SANTOS"	"1977-02-25"
"CLAUDINEY DO NASCIMENTO"	"1962-09-10"
"LUCAS OLIVEIRA VILAS BOAS"	"1988-02-11"
"KELLY CRISTINA PEREIRA DE ASSIS"	"1976-04-15"
"JACKSON FERREIRA DOS SANTOS"	"1975-02-03"
"OTEVALDO ANTÔNIO DA SILVA"	"1971-12-28"
"GUSTAVO GALASSI GARGALHONE"	"1969-07-04"
"ANDREIA CRISTINA DE FREITAS PASSOS DE OLIVEIRA"	"1985-12-21"
"HUDSON BORGES LIMA"	"1981-05-28"
"ALINE SOARES DA COSTA"	"1991-10-06"
"VERÔNICA CAROLINA MATEUS FRAGA"	"1993-12-14"
"MÁRCIO ANTÔNIO LOURENCO MARTINS"	"1969-04-28"
"EDUARDO TEODORO ROCHA AZEVEDO"	"1983-05-12"
"LUIS GUSTAVO ROEL DA SILVA"	"1982-08-31"
"MARIA CONCEIÇÃO DE MELO"	"1965-05-31"
"GUSTAVO MARTINS DE SA"	"1975-05-30"
"LEANDRO OLIVEIRA DO PRADO"	"1985-05-06"
"CARLOS ANTONIO RIBEIRO"	"1962-08-20"
"ROSENEY JOSE DOS ANJOS"	"1977-05-15"
"FABIANA DE MOURA ALVES"	"1978-05-22"
"THAÍS SOUSA CAMARGOS"	"1993-05-21"
"GILMAR FAUSTO SANTOS"	"1989-03-08"
"CÉLIO EUSTAQUIO DA SILVA"	"1976-01-06"
"REGINALDO ALVES RESENDE"	"1968-10-20"
"FLAVIO PEREIRA DE LIMA"	"1982-07-12"
"GILBERTO ADENIÊ CUNHA"	"1962-07-05"
"WILSON MARTINS SANTANA"	"1951-09-10"
"RAYR GONÇALVES LIMA"	"1992-02-12"
"CARLOS EDUARDO FONSECA"	"1982-03-25"
"MACIEL FERNANDES RODRIGUES AMORIM"	"1983-07-05"
"AGNALDO SOARES DE SOUSA"	"1973-09-11"
"JUNIA ALBA GONÇALVES"	"1966-12-30"
"SIMONE BATISTA PEREIRA"	"1970-06-23"
"DIORDEN DIOFFTTO PAIVA DA SILVA"	"1981-02-15"
"JONATHAN HENRIQUE SANTOS"	"1987-03-10"
"FRANCISCO DAS CHAGAS SANTOS BEZERRA"	"1957-10-17"
"ANDERSON LIMA DA SILVA"	"1978-01-06"
"JÚLIO CESAR FELISBINO"	"1964-10-23"
"ANTÔNIO CARLOS CARRIJO"	"1962-09-22"
"SILESIA VERSIANI MAGALHAES"	"1972-08-21"
"GILVAN MASFERRER"	"1990-06-09"
"DEINER LUIZ OLIVEIRA"	"1979-03-30"
"RUTH GONCALVES BORGES"	"1984-05-14"
"ROSICLEIA QUEIROZ DOS SANTOS"	"1991-03-22"
"ELIUSMARCIO ALVES DE CARVALHO"	"1972-02-13"
"THIAGO FERNANDES MENDES DA SILVA"	"1983-11-21"
"JOÃO JOSÉ DE FARIA NETO"	"1980-02-01"
"SILVIO FERREIRA DE SANTANA"	"1977-05-15"
"LEONARDO NATALI CHRISTINO"	"1960-12-25"
"RAFAEL CAMARGO SILVA"	"1986-11-11"
"GERALDO JABBUR BRAGA"	"1952-02-23"
"FLAVIA REZENDE CARDOSO"	"1965-11-10"
"EDEILSON PEREIRA DA SILVA"	"1970-05-16"
"ELIEZER SANTOS BELLO"	"1976-07-26"
"CELISVALDO DA SILVA"	"1972-03-17"
"UINTER ARAUJO SILVA"	"1980-11-14"
"MAYCON GARCIA DE FREITAS"	"1987-12-19"
"GUILHERME PEREIRA SILVA"	"1990-09-12"
"OSAIR JOSE FERNANDES SANTIAGO"	"1977-11-12"
"ANTÔNIO AUGUSTO GONÇALVES GOULART"	"1977-06-13"
"LENI DA SILVA"	"1967-07-31"
"JAIRO ALEXANDRE DA SILVA CERQUEIRA"	"1976-10-08"
"CÁSSIO EDUARDO RODRIGUES DA SILVA"	"1984-05-22"
"ANDRE LUIS MALAQUIAS"	"1962-10-30"
"MOISES CARLOS DA SILVA"	"1964-10-10"
"ANA CRISTINA PORFIRIO RIBEIRO"	"1975-10-31"
"MATHEUS FILLIPE GONCALVES PEREIRA"	"1994-01-12"
"JOÃO CALAÇA DA ROSA JÚNIOR"	"1977-11-16"
"CLAUBIA JULIO OLIVEIRA"	"1977-10-03"
"RODRIGO JOSÉ RIBEIRO"	"1979-02-05"
"REGINALDO RODRIGUES DA SILVA"	"1978-04-29"
"ANTONIA APARECIDA CONCEICAO DE OLIVEIRA COSTA"	"1965-03-16"
"RENATO DE SOUZA VIEIRA"	"1970-08-09"
"PEDRO MIGUEL DE ARAUJO"	"1963-05-30"
"ELAINE CRISTINA VIEIRA NAVES DE SOUSA"	"1981-03-25"
"ANA PATRICIA GONÇALVES MIRANDA"	"1970-03-03"
"DIVINO TADEU NASCIMENTO"	"1958-09-25"
"ANDERSON SILVA DE LIMA"	"1973-03-27"
"MICHAEL AMARAL FERREIRA"	"1988-05-13"
"JOEL RODRIGUES DE PAULA"	"1971-11-19"
"MISAC LACERDA MENDONCA"	"1961-05-13"
"ANDRÉ AMARAL DE OMENA"	"1976-08-02"
"JOSÉ HUMBERTO LEMES"	"1955-08-23"
"FRANCISCO RODRIGUES DA SILVA"	"1965-07-05"
"GRACIELLE TEIXEIRA SILVA"	"1985-08-09"
"PATRICIA ADRIANA DOS SANTOS SILVA"	"1977-01-03"
"CLARICE DE FÁTIMA DANTAS"	"1978-09-11"
"MARCIO DE LOURDES SILVA"	"1966-02-11"
"ROOSEVELT JOAO MARQUES"	"1968-04-14"
"CARITA ALVES DE MOURA LOPES"	"1970-01-01"
"SERGIO GUSTAVO CARVALHO"	"1978-09-15"
"ADRIANO SANTOS"	"1988-12-26"
"OVIDIO ANTONIO DE CARVALHO"	"1959-08-13"
"CASSIANA BRUNETTO SPACEK"	"1981-04-13"
"ZEIZA MATILDES DA SILVA"	"1971-11-16"
"DIONE LOPES FERNANDES"	"1976-12-10"
"SILVÂNIA LOPES DE SOUZA CAMPOS"	"1973-06-30"
"ERIVALDO JOSE FERREIRA"	"1974-08-11"
"GUIMES RODRIGUES FILHO"	"1959-11-30"
"HAIDA VIVIANE PALHANO ARANTES"	"1973-06-16"
"KLEBER DE OLIVEIRA SANDES"	"1985-12-26"
"TIAGO FERREIRA SANTOS"	"1990-01-28"
"VANDERSON ESTEVÃO SOBRINHO"	"1981-06-01"
"ELIAS NUNES MOREIRA"	"1966-11-08"
"ADRIANO ZAGO"	"1973-04-14"
"SERVIO TULIO FELIX SIMÕES FILHO"	"1989-03-22"
"VALÉRIA PIANGELI TAVARES"	"1978-05-16"
"AIRTON DE OLIVEIRA PINHAL"	"1964-06-16"
"LUCIANA APARECIDA DA SILVA SANTOS"	"1973-08-09"
"ELIAS GOMES"	"1965-02-15"
"ALAN CARLOS SILVA"	"1987-05-29"
"DAVID SOARES FRUTUOSO"	"1966-07-31"
"MARIA TEREZINHA LIMA DE SOUZA"	"1966-03-26"
"JOAO ALVES DE CARVALHO"	"1966-09-15"
"SANDRA LUIZA ALVES GODOY MALASPINA"	"1965-09-14"
"JEFFERSON RESENDE RANGEL"	"1975-03-16"
"MARCO TULIO VEIGA"	"1975-03-14"
"SÍLVIO ALVES CAMILO"	"1974-04-01"
"EVELIN DE CASTRO CARDOSO"	"1979-09-23"
"SEBASTIÃO PEDRO DE BARROS"	"1952-05-10"
"CLARAMILA SILVA SANTOS"	"1994-10-27"
"AUGUSTO CÉZAR GOMES RIBEIRO"	"1983-01-14"
"JOANA D ARC FERREIRA"	"1962-08-14"
"DAIRA KELI SAMPAIO"	"1985-06-03"
"GUSTAVO MENEZES CARDOSO"	"1976-04-10"
"ANNA PAULA DA SILVA REIS"	"1974-02-21"
"HELIOMAR CANDIDO PEREIRA"	"1963-08-22"
"BERNADETE LINO DA SILVA"	"1973-08-05"
"ELIANE QUINTINO DE LIMA DOS SANTOS"	"1971-07-31"
"JOSE JERONIMO SOBRINHO"	"1968-08-20"
"ROSANGELA CRISTINA DE MOURA"	"1953-07-07"
"JONES MALANCHE"	"1983-12-29"
"LUIZ CARLOS SARAIVA"	"1941-05-18"
"GILDÁSIO DE JESUS OLIVEIRA"	"1991-01-07"
"CLARA LUCIA DE ANDRADE"	"1965-06-15"
"JOSE RONALDO PEREIRA"	"1968-03-19"
"ARENO DE OLIVEIRA"	"1963-12-11"
"ALEX SANDRO RODRIGUES MORAES"	"1971-09-07"
"ROBERTO SIDNEI DA SILVEIRA"	"1968-10-09"
"ALFREDO DIAS BERNARDES NETO"	"1994-09-22"
"JOSÉ FURTADO DE SOUSA"	"1968-01-08"
"DANIEL HEBERTE SILVA"	"1982-02-14"
"LAADE DE OLIVEIRA SILVA"	"1985-02-28"
"SEBASTIÃO CAETANO DOMINGOS"	"1964-05-10"
"LAURA MARIA BARBOSA DA SILVA"	"1984-05-26"
"CARLOS EDUARDO NOVAES"	"1976-03-04"
"MEIRE MARIA DE ANDRADE"	"1952-02-27"
"GILBERTO REZENDE SOBRINHO"	"1967-06-04"
"PEDRO DOS REIS VAZ NETO"	"1978-04-20"
"ERIKA DESIREE OLIVEIRA SIMEÃO"	"1980-10-24"
"MAXIMINO MENDES RIBEIRO NETO"	"1980-04-01"
"THAÍS ANDRADE SILVA"	"1978-08-10"
"FAUSTO RODRIGUES DE OLIVEIRA"	"1975-09-14"
"AGNALDO MARQUES PEREIRA"	"1975-09-20"
"ROSE MARA ESPÍNDOLA ANTUNES"	"1970-02-12"
"CONRADO AUGUSTO FERREIRA DE OLIVEIRA"	"1989-04-15"
"CLÉRIA MARIA COUTO DE SOUZA RODRIGUES"	"1979-06-03"
"IOHANY DOS SANTOS RAMOS"	"1993-05-04"
"DANIEL EDUARDO DA SILVA"	"1983-11-18"
"FLEXTONI FERNANDES RODRIGUES"	"1965-06-22"
"EDUARDO MILKEN"	"1951-09-04"
"BRUNO CAMARGOS DIAS"	"1986-07-21"
"OLIVIA APARECIDA ROLAND"	"1956-12-28"
"APARECIDA PEREIRA DOS SANTOS ALMEIDA"	"1956-01-15"
"HELIO JOSÉ DE CARVALHO"	"1968-10-28"
"OCIMAR CÂNDIDO FERREIRA MALAQUIAS PRETO"	"1966-08-04"
"ROSILENE DE OLIVEIRA BRANDÃO SILVA"	"1972-09-23"
"IGINO MARCOS DA MATA DE OLIVEIRA"	"1972-03-12"
"LEIDA MARCIA DE OLIVEIRA MAXIMO"	"1975-10-04"
"FABIO NUNES CRUVINEL"	"1978-07-17"
"KETHULLYN REIS BRASILEIRO DE FREITAS"	"1996-09-13"
"BRUNO PEREIRA"	"1993-07-05"
"ROSE MARY MARTINS FERNANDES"	"1970-08-28"
"JULIANA MARIA DOS SANTOS"	"1979-06-13"
"ANDRE LUIZ MENDES"	"1969-11-18"
"VALTER LUIZ TAVARES"	"1980-05-28"
"RICHARD XAVIER DA SILVA VIEIRA"	"1981-06-18"
"DIONILO CÂNDIDO FILHO"	"1967-02-06"
"HENRIQUE DA SILVA RAFAEL"	"1975-07-27"
"WEMERSON HONORATO DE SOUZA"	"1984-05-11"
"LUIS OTÁVIO ALVES GOMES"	"1994-04-12"
"ROGERIO SARAIVA"	"1962-11-26"
"FRANKMANY MEDEIROS DE OLIVEIRA"	"1974-08-21"
"LEONARDO SOARES FERREIRA"	"1973-07-22"
"AURETIANO NUNES MOREIRA"	"1949-06-22"
"ANGELA APARECIDA CAETANO SOUZA"	"1972-11-08"
"JORGE PEREIRA DA SILVA"	"1968-06-04"
"MARIA DE FÁTIMA DELFINO"	"1959-02-14"
"RONES BARBOSA"	"1973-06-24"
"AMANDA ALVES DOS SANTOS"	"1996-12-30"
"NILSON EURIPEDES GOMES"	"1960-12-16"
"MARCIANO CARDOSO DE SOUZA"	"1981-01-14"
"JOÃO VICTOR OLIVEIRA DA SILVA"	"2002-08-16"
"EBER CAIXETA DE CARVALHO"	"1981-01-27"
"ANTÔNIO JOSÉ DE ARAÚJO MENDES"	"1973-01-25"
"EDUARDO BORGES MORAES"	"1989-06-14"
"EVALDO GONCALVES CAIXETA"	"1970-02-26"
"IRACI JOSÉ DA SILVA FILHO"	"1955-01-17"
"CLAUDNE BATISTA ALVES"	"1966-03-09"
"IORRANA JULLYCE SILVA"	"1989-07-26"
"CLAUDIO PEREIRA"	"1946-02-06"
"ANA CLAUDIA FRONTAROLLI"	"1971-05-15"
"RODRIGO RAMOS DE MORAIS"	"1973-04-12"
"ANDRÉ JANSSON"	"1965-08-01"
"ZEFERINO LUIZ SANTOS"	"1977-11-15"
"PAULO CÉSAR CUSTÓDIO"	"1983-05-25"
"DANDARA TONANTZIN SILVA CASTRO"	"1994-01-23"
"ISABELA JUNHO SOLOGUREN"	"1981-09-12"
"LUIZ EDUARDO RIBEIRO DE SA"	"1979-04-30"
"ODAIR JOSE DA SILVA"	"1973-04-18"
"APARECIDA MARTINS MAGALHÃES"	"1965-08-16"
"LUIZ ALEXANDRE NEVES DUARTE"	"1991-09-15"
"WESLEY SOARES DOS SANTOS"	"1985-02-16"
"RODRIGO SILVA CARDOSO"	"1982-05-05"
"CRISTIANO LUIZ DE SOUZA"	"1977-04-26"
"JOANA DA CONCEIÇÃO DE SOUZA GAMA"	"1970-12-08"
"NILTON CARLOS ALVES DURÃES"	"1983-11-22"
"LEONIDIO HENRIQUE CORREA BOUÇAS"	"1961-11-09"
"ANGELO COSTA SOARES"	"1976-07-19"
"ABADIA ROSARIA DE CASTRO RODRIGUES"	"1968-03-19"
"RODRIGO NICOLAU ELIAS DE OLIVEIRA"	"1990-06-15"
"ELISABETH PEREIRA DA SILVA"	"1977-07-18"
"THEREZINHA DE JESUS MENEZES SABIO"	"1946-01-29"
"NEI CARLOS BORGES"	"1969-07-06"
"MARCOS ANTONIO SILVA ARANTES"	"1965-09-17"
"GRAZIELA DE OLIVEIRA SOARES SANZONE"	"1976-08-05"
"GESSILENI DA SILVA DIAS"	"1991-06-15"
"FRANCYS FELISBERTO"	"1961-10-12"
"JOSÉ NICOMEDES FERNANDES MANZINI"	"1973-02-24"
"GENIVALDO MACHADO SILVA"	"1981-02-15"
"JOELISIO SILVA CORDEIRO"	"1966-01-04"
"GISLAINE CAIXETA DE QUEIROZ"	"1964-02-13"
"LEIDIANE BATISTA EVANGELISTA"	"1984-10-20"
"HELOIZA RODRIGUES SANTANA"	"1986-12-09"
"GERALDO JABBUR BRAGA"	"1952-02-23"
"LIZA FERNANDES PRADO"	"1963-09-17"
"DELMA INÁCIA MACEDO"	"1959-07-22"
"ELOÍSA TELES DE ALMEIDA"	"1980-10-13"
"DEBORA PAULA TANO MARTINS"	"1982-09-10"
"MARKUS FELIPE DE OLIVEIRA SALLES"	"1994-12-14"
"NIVALDO AFONSO"	"1969-11-01"
"ARTHUR LUIZ FERREIRA"	"1997-12-11"
"EIDES GONÇALVES EUGÊNIO DA SILVA"	"1955-09-22"
"TATIANE BATISTA MARTINS CORREIA"	"1982-01-19"
"EDUARDO RESENDE DE ARAÚJO"	"1977-08-01"
"MAGALHÃES RAMOS MACHADO"	"1962-09-06"
"FLAVIO JOSE FERREIRA"	"1973-04-01"
"GERALDO CALIXTO"	"1959-02-01"
"MARGARETH LOUISE LAMOUNIER"	"1968-03-25"
"ROSANA ABADIA FERREIRA"	"1972-01-27"
"OSMAR LUIZ DE FREITAS"	"1967-02-21"
"FRANCIELE CUSTODIO ROSA"	"1980-12-04"
"RONALDO ROSA DE SOUZA"	"1966-08-05"
"CARMITA DIVINA QUIRINO"	"1974-09-15"
"LEANDRO MENDES DE ARAUJO"	"1983-05-16"
"DIOGO DA SILVA FERNANDES"	"1992-08-23"
"KAROLINA DE CASTRO CORDEIRO ALVARENGA"	"1979-07-27"
"MASTROIANO DE MENDONÇA ALVES"	"1969-01-29"
"FREDERICO BORGES URZEDO"	"1976-12-05"
"JULIO CESAR ORIAS TEODORO"	"1972-10-23"
"SUSILENE FERREIRA DE OLIVEIRA"	"1968-08-14"
"JOSE RICARDO DE SOUSA LIMA"	"1979-04-17"
"ACACIO RIBEIRO DA SILVA PONTES"	"1975-01-11"
"GUSTAVO HENRIQUE DE LIMA RIBEIRO"	"1994-10-31"
"DANIEL MATOS DA SILVA"	"1991-03-24"
"JAINATON MARCOS DE JESUS SILVA"	"1983-08-07"
"GABRIELA BARCELOS VITORINO"	"2000-11-07"
"ROGERIO BALBINO DANTAS"	"1976-05-01"
"CLEUSA MARIA DA CUNHA"	"1970-10-28"
"DIOGENES NUNES DA COSTA JUNIOR"	"1958-08-13"
"JOSÉ MACIEL CAMPOS"	"1963-11-02"
"MARIA ABADIA PERES TANNUS"	"1963-12-20"
"MATEUS SILVA SANTOS"	"1989-09-13"
"BRAULIO MARCOS CARDOSO ALVES"	"1988-06-17"
"SELMA IÊDA VASCONCELOS PRADO"	"1976-11-04"
"GASPAR FONSECA DE REZENDE"	"1975-10-23"
"MARIA DE FÁTIMA SOUSA CATUNDA"	"1958-11-27"
"GIANCARLO FERNANDES SOARES"	"1983-01-06"
"FILIPPE BRITO VENANCIO"	"1994-12-29"
"EDUARDO ELIAS DE LIMA"	"1954-07-20"
"AMAURY ALVES DA SILVA"	"1987-11-15"
"FABÍOLA BENFICA MARRA"	"1977-10-18"
"MORGANNA DE CÁSSIA VIEIRA SOUSA"	"1988-08-15"
"GUILHERME PINHEIRO DE FREITAS"	"1979-12-11"
"SEVERTON PEREIRA DA SILVA"	"1970-12-13"
"LEONARDO ALMEIDA DE JESUS"	"1994-07-17"
"FABIANA MARTINS DOS REIS"	"1985-04-12"
"FRANCIELLE CLARA TEIXEIRA"	"1980-06-25"
"RUTE CANDIDA DA SILVA SANTOS"	"1973-05-22"
"SILVIO JOSÉ DOS SANTOS"	"1977-06-24"
"SIMONIDES RODRIGUES DE LIMA"	"1957-06-20"
"ANDRE LUIZ FURTADO EVANGELISTA"	"1949-08-10"
"JUCELIA DE SOUZA"	"1990-03-15"
"GERALDO BISPO PEREIRA"	"1978-01-28"
"MARIO JOSE DE SOUSA JUNIOR"	"1965-02-20"
"CLAUDIONOR CARLOS"	"1979-11-19"
"REGINA APARECIDA DE ARAÚJO"	"1979-05-08"
"PRISCILA ALVES BATISTA"	"1986-08-20"
"STEVERSON MARQUES DOS SANTOS"	"1966-01-15"
"ROBISON DIVINO ALVES"	"1960-01-12"
"MARCO FLÁVIO RODARTE PARREIRA"	"1979-09-12"
"ALENIR RODRIGUES XAVIER"	"1960-10-21"
"IRINEU VIEIRA GARCIA"	"1958-12-25"
"RILDO DE OLIVEIRA SILVA"	"1978-02-19"
"ALUISIO ANTONIO QUEIROZ"	"1957-10-28"
"JACQUELINE AIMÊ DOS REIS VILELA"	"1986-01-24"
"LEANDRO CASSIANO NEVES"	"1982-08-18"
"MARIA RITA DE ASSIS RABELO TEIXEIRA"	"1978-01-25"
"WANDERSON BATISTA FERREIRA"	"1962-11-26"
"OSMAR DONIZETE DA SILVA"	"1955-09-16"
"FRANK JANES FRANCISCO"	"1961-04-07"
"WALQUIR CLEUTON DO AMARAL"	"1982-01-21"
"JOÃO VITOR OLIVEIRA MACEDO"	"2001-08-27"
"ALTTAIR ALVES DE OLIVEIRA"	"1987-05-08"
"MURILO FERREIRA ALVES"	"1980-04-12"
"OSWALDO ANDRADE FILHO"	"1977-06-25"
"VANESSA GONCALVES SANTOS"	"1983-05-22"
"VÂNIA MADALENA MENDONÇA"	"1966-04-11"
"FABIANA CAMARGO ALVES"	"1974-01-30"
"ANGELICA TAVARES DE BARROS"	"1985-08-19"
"FABIO DIAS QUEIROZ ZAVITOSKI"	"1980-07-12"
"ANA RITA DE FARIA"	"1974-12-29"
"APARECIDA DE FATIMA FRANCO MOTA"	"1967-12-27"
"EDNALDO RÉGIO DE LIMA"	"1975-04-19"
"MÁRCIO DÚLIO DE OLIVEIRA"	"1979-01-21"
"JOAO FABRICIO NASCIMENTO"	"1981-02-06"
"MARCELO OLIVEIRA SILVA"	"1978-11-14"
"CLAUDIO ADRIANO DA COSTA ROSA"	"1970-08-31"
"WAGNA APARECIDA CORREIA TIAGO"	"1978-09-25"
"JUMAR JACOB DINIZ"	"1963-08-22"
"PAULO CESAR ALVES ROCHA"	"1965-05-30"
"MARIA DE LOURDES LIMA SOARES"	"1968-09-16"
"BLENER DE SOUZA FERREIRA SILVA"	"1991-04-17"
"ROSELIA ALVES DOS SANTOS"	"1976-05-25"
"MAXWELL RODRIGUES COSTA"	"1980-08-11"
"ALINE SOUZA BRITO"	"1996-09-02"
"WARLEY EUSTAQUIO RODRIGUES ALVES"	"1972-05-18"
"JOSÉ EMÍDIO PEREIRA"	"1965-10-15"
"JANAINA GUIMARAES PARREIRA REZENDE"	"1975-06-08"
"SILVIO BRAZ DE BARCELOS"	"1980-06-17"
"ERLI JOSE VAZ"	"1967-08-01"
"EDUARDO MATEUS ALVES BORGES"	"1991-12-10"
"ANA LARISSA SANTOS GUEDES"	"1990-04-17"
"JAIR CARNEIRO FERRAZ"	"1988-03-18"
"FABIA MARA DA SILVA"	"1979-01-24"
"JOICE ELIAS DA SILVA"	"1997-02-12"
"GLAUCIA GALANTE BUISSA"	"1964-04-07"
"ELETICIA GOMES DAS GRACAS"	"1979-09-24"
"ROBERTA BALDOINO FRANCO"	"1984-06-07"
"WELITON FELICIANO ARMANDES"	"1976-09-02"
"PAULO SÉRGIO FERREIRA"	"1964-11-09"
"GRAZIELA SILVA SANTANA DOS REIS"	"1981-09-25"
"SOLEMAR BORGES"	"1972-06-14"
"ELEODORO NUNES BORGES"	"1956-09-13"
"WEBERSON DOS REIS GOMES"	"1979-10-30"
"GERALDO MAGELA GONÇALVES DORNELES"	"1968-10-16"
"JUSCLEITON DE OLIVEIRA"	"1976-11-27"
"JAIRO JOSE RIBEIRO"	"1972-11-10"
"KELI DE MELO SILVA LANES"	"1984-03-01"
"ANTÔNIO VENÂNCIO FERREIRA NETO"	"1965-05-03"
"DENILSON GONÇALVES DA SILVA"	"1977-09-12"
"SÔNIA SOARES DE ARAÚJO BESSA"	"1978-12-06"
"MATHEUS TOMAZ GONÇALVES RAMOS"	"1993-02-24"
"HUGO JOSÉ DE PAULA MARTINS ZAPAROLLI"	"1987-05-24"
"ANA CAROLINA SILVEIRA MARTINS"	"2005-04-20"
"SOCRATES RODRIGUES QUEIROZ"	"1981-07-31"
"VALCEMIR NAZARE SILVA"	"1993-05-31"
"NILTON CAETANO DOS SANTOS"	"1961-08-24"
"DELFINO EURÍPEDES MARQUES RODRIGUES"	"1966-07-16"
"FLAVIANO MARTINS"	"1978-02-02"
"CLÁUDIA COSTA GUERRA"	"1969-08-10"
"ROLDÃO MAIA DE OLIVEIRA"	"1973-05-17"
"EDELVAN CAMPOS ARAÚJO"	"1991-01-27"
"ABATENIO DE ANDRADE MARQUEZ NETO"	"1975-01-18"
"RICARDO PEREIRA NETTO"	"1981-10-01"
"ALEXANDRA DA ROCHA SARDELLA"	"1973-05-07"
"WILLIAM DOMINGOS"	"1976-03-14"
"CATHERINE NAGHETTINI"	"1994-03-24"
"PEDRO GENOINO DA SILVA"	"1970-06-28"
"JULIANE MARTINS PACHECO"	"1995-02-11"
"MINEIA NUNES DE SOUZA CARVALHO RENDE"	"1979-12-14"
"ÉLICA BORBA DA CONCEIÇÃO"	"1979-08-26"
"SAMOEL MOURA DA SILVA"	"1967-02-16"
"REJANE RODRIGUES DE SOUZA"	"1978-07-22"
"ELTON CÉSAR PRATES"	"1972-02-14"
"LIA EUNICE VALECHI DA SILVA"	"1982-03-26"
"STEFANE LAIRA MIRANDA PEREIRA"	"1998-06-07"
"JOSEILDO TEOTONIO DA SILVA"	"1958-05-02"
"HAMILTON DOS SANTOS"	"1969-03-20"
"UERLEI JOSE DE SOUZA"	"1969-01-16"
"MAYK ANTONIO ALVES MOREIRA"	"1992-12-17"
"GLEICIMAR CAVALCANTE TELES"	"1964-09-19"
"VANDERLEI PELIZER PEREIRA"	"1965-09-30"
"RONALDO CESAR VILELA TANNUS"	"1982-09-11"
"PAULO ROBERTO SILVA GOMES"	"1964-07-06"
"LORRAINE MARTINS DA SILVA"	"1990-09-12"
"NELSON JOSE DA COSTA"	"1961-05-30"
"RAQUEL SILVEIRA CROSCATTO"	"1988-08-07"
"NEIVALDO HONÓRIO DA SILVA"	"1965-10-10"
"CLENIZE DAS GRACAS COELHO RESENDE BORGES"	"1965-08-01"
"JOANA DARC QUEIROZ CURY"	"1968-05-26"
"ANA PAULA FERREIRA ARRUDA SANTOS"	"1980-09-29"
"PATRÍCIA GOUVEIA DAMASCENO"	"1986-02-08"
"GUSTAVO ROBERTO DE SOUZA"	"1991-08-07"
"DÉBORA MENEZES ESPIR"	"1979-12-16"
"REYLER HERCULANO VALDIVIA"	"1993-02-10"
"VITORNELIO EZEQUIEL DE SOUZA"	"1968-02-08"
"TÂNIA LÙCIA DOS SANTOS"	"1971-11-18"
"JANINE DE QUEIROZ DIAS ABRÃO POLO"	"1985-03-02"
"CLEBER LAMARTINE GUIMARÃES"	"1981-07-10"
"LORENA MONIQUE FERREIRA DE ALMEIDA"	"1994-04-26"
"SERGIMAR ANTÔNIO DE MELO"	"1976-06-23"
"MARCELO MENDES CUNHA"	"1969-06-10"
"ADICIONALDO DOS REIS CARDOSO"	"1955-10-14"
"CLAUDIO DE ALMEIDA FERNANDES"	"1975-04-14"
"FÁBIO GUILHERME DEPIN"	"1979-06-11"
"IVAN DA SILVA NUNES"	"1975-08-23"
"JEAN PIERRE ZAGO"	"1975-03-05"
"MARIA CLARA SANTOS PASSOS"	"1999-10-06"
"RANIERY STANLEY GONCALVES"	"1984-08-31"
"GILSON EDUARDO ROSA"	"1984-01-17"
"TEOBALDO TERÊNCIO"	"1964-03-20"
"OSWALDO DE SOUZA JUNIOR"	"1979-06-26"
"CELSO DE SOUSA"	"1947-10-24"
"ERIVAN MAGALHAES MORAES"	"1962-04-11"
"ROSENVALDO CORREIA DE MENDONÇA"	"1973-07-12"
"OSMAR DUQUE DA SILVA"	"1970-03-12"
"FABIO VLADIMIR SILVA"	"1972-03-17"
"ENEZIO RODRIGUES DE SOUZA FILHO"	"1964-04-09"
"SAMUEL PEREIRA MOREIRA"	"1968-12-17"
"ROBERTO FERREIRA FONTOURA"	"1989-04-25"
"ADRIANA MARIA DA SILVA"	"1973-11-21"
"LUIS PAULO FERREIRA ROCHA"	"1994-08-28"
"DAVI VICTOR MACIEL DA SILVA"	"1999-06-11"
"RICARDO DOS SANTOS"	"1970-07-29"
"REGINALDO SILVA RIBEIRO"	"1992-02-14"
"GLEICE GONÇALVES DO NASCIMENTO MOREIRA"	"1971-12-31"
"VIVIANE APARECIDA DA SILVA"	"1981-04-09"
"FELISBERTO PEREIRA DE SOUSA SOBRINHO"	"1965-11-08"
"EDNA LUIZA BULGARELLI IDE"	"1974-01-09"
"MARIA CAMILA DA SILVA"	"1999-01-03"
"CUSTODIO TEIXEIRA DAMASCENO"	"1958-05-30"
"NILIA RAMOS PEREIRA"	"1975-01-01"
"BÁRBARA SILVA NOGUEIRA"	"1998-05-04"
"RAPHAEL MESSIAS LELES"	"1983-06-08"
"DANNY PAOLLO LEITE DE ARRUDA"	"1979-06-20"
"LUCILEIDE MARIA DA SILVA"	"1973-05-13"
"FABIO MENDES DE SOUZA"	"1979-10-27"
"JEANE CARLA TAVARES E SILVA"	"2001-04-06"
"ROBERTO CARDOSO BARANOWSKI"	"1963-01-11"
"ALEXSANDER RUFINO BORGES"	"1968-03-26"
"LAISA PEREIRA DA ROCHA"	"1987-05-26"
"ELIENE CHAVES DE OLIVEIRA"	"1983-03-24"
"LEOPOLDO NAPOLEAO DE OLIVEIRA NETO"	"1956-08-28"
"JOEL JESUS DOS SANTOS"	"1996-01-31"
"MANOEL NOGUEIRA DA COSTA"	"1962-09-28"
"ILEUZA AIRES DE SOUZA FELIPE"	"1960-09-11"
"MARIO SOUZA ARAUJO"	"1973-09-22"
"JOSIMAR JOSÉ FERNANDES DE JESUS"	"1986-07-08"
"WALLACE FERNANDES DE ALECRIM"	"1984-09-15"
"CACILDA FLORENTINO DE ANDRADE"	"1961-11-17"
"GEOVANIA DIAS DA COSTA"	"1978-07-11"
"VALTER VELASCO DE ANDRADE JUNIOR"	"1967-04-02"
"HAROLDO CARDOSO SOARES"	"1956-10-25"
"JOÃO BATISTA FERREIRA RIBEIRO"	"1970-10-23"
"VALDEIR JOSÉ PEREIRA"	"1959-12-13"
"SANDRA APARECIDA JOSIAS"	"1976-10-12"
"MARIA APARECIDA FERNANDES"	"1967-06-07"
"MARCOS RIBEIRO DE MORAIS"	"1980-05-23"
"LUCELIA ROQUETE FRANCO"	"1973-03-22"
"SÉRGIO RODRIGUES DE SOUSA"	"1971-11-07"
"VALÉRIA SILVA MORAIS RODRIGUES"	"1972-12-13"
"GUSTAVO OLIVEIRA AMARAL"	"1981-09-22"
"SERGIO LUCIO DE ALMEIDA"	"1960-03-21"
"FERNANDO MARIANO FERREIRA"	"1987-08-07"
"BIA CARLA BORGES FREITAS"	"1987-05-19"
"ARNALDO DE LIMA FILHO"	"1958-02-01"
"ANA FLÁVIA MEDEIROS"	"1980-10-31"
"HARLEY LOURENCO DE MIRANDA"	"1976-01-10"
"ADEMILSON MARQUES MOREIRA"	"1973-01-16"
"CLAUDIO HUMBERTO LINO"	"1969-03-10"
"PAULO CESAR DE OLIVEIRA NAVES"	"1954-01-30"
"LAYLA DANIELA DE MELO"	"1984-07-31"
"LOURIVAL APARECIDO SERAFIM PEIXOTO DOS SANTOS"	"1961-02-09"
"MARILSON FERNANDES DE OLIVEIRA"	"1970-03-14"
"LEONARDO SANTOS FERREIRA"	"1975-02-12"
"ANA MARIA DE FREITAS"	"1964-10-20"
"ROSELI MARTINS DE OLIVEIRA"	"1964-07-19"
"CELIA DOS SANTOS"	"1965-09-08"
"MATEUS ANTUNES GRACIANO"	"1998-04-23"
"IARA CRISTINA MACEDO AMARAL"	"1984-02-04"
"CELSO ARANTES MARTINS"	"1969-09-04"
"HELENICE MARIA CARDOSO"	"1963-01-07"
"SÉRGIO MAURO BELO"	"1956-05-23"
"OSVALDO LEANDRO DE ARAUJO"	"1954-08-31"
"PATRÍCIA CRISTINA SILVA LOPES"	"1982-10-13"
"VERA PRIMAVERA RODRIGUES"	"1984-07-04"
"ALEXANDRE LUIZ DOS SANTOS"	"1983-08-14"
"ROQUE ANTONIO DE MORAES"	"1962-04-25"
"EDSON CARVALHO FERREIRA"	"1976-08-26"
"BRUNO RAFAEL SILVA MEDEIROS"	"1989-12-02"
"JOSÉ PEREIRA DOS SANTOS"	"1971-07-04"
"ANA CAROLINA JACOB DA CRUZ"	"2000-12-13"
"CÉLIO LACERDA MENDONÇA"	"1964-01-03"
"JARDEL ALVES PESSOA"	"1979-10-23"
"JOSÉ APARECIDO RIBEIRO"	"1963-12-21"
"WILMA DA SILVA"	"1954-05-19"
"THIAGO DE OLIVEIRA SANTOS"	"1985-09-05"
"HENRIQUE APARECIDO CARVALHO DA SILVA"	"1985-01-09"
"RONALDO AMÉLIO FERREIRA"	"1974-05-12"
"DARUANY AMARAL MARTINS"	"1988-06-14"
"REJANE MARIA ALVES SILVA"	"1970-06-26"
"DAPHINY OLIVEIRA COSTA SILVA"	"1982-10-02"
"RONALDO BASTOS RAMOS FILHO"	"1983-07-22"
"JEOVANE ALEX FERRETE"	"1974-10-08"
"CLAYTON PEIXOTO DA CUNHA"	"1974-08-16"
"DANILO RODRIGUES LOPES"	"1983-07-01"
"LORENA SANTOS OLIVEIRA"	"1991-08-26"
"JOSIMAR JOSE FERNANDES DE JESUS"	"1986-07-08"
"DANIEL DA SILVA"	"1969-11-04"
"CELIO JOSÉ DA SILVA"	"1956-04-16"
"SYLVIO DE OLIVEIRA JUNIOR"	"1965-11-08"
"JUCÉLIO SILVA CORDEIRO"	"1970-06-03"
"ENZO HENRIQUE GARCIA DE OLIVEIRA"	"2004-09-02"
"AMANDA THAYLASSA GONDIM FERREIRA"	"1989-03-01"











